Script started on 2020-02-20 16:12:23-05:00 [TERM="xterm-256color" TTY="/dev/pts/3" COLUMNS="80" LINES="24"]
\bash: /home/umrigar/cs240/bin/student.rc: Permission denied
aceylan1@g7-22:~/i240a/submit/lab4$ \[Kls
1-point  2-shape  3-expr  lab4.LOG  Makefile
aceylan1@g7-22:~/i240a/submit/lab4$ cd 1-point
aceylan1@g7-22:~/i240a/submit/lab4/1-point$ ls -l
total 12
-rw-r--r-- 1 aceylan1 aceylan1 1174 Feb 20 16:11 main.cc
-rw-r--r-- 1 aceylan1 aceylan1  533 Feb 20 16:11 point.cc
-rw-r--r-- 1 aceylan1 aceylan1  654 Feb 20 16:11 point.hh
aceylan1@g7-22:~/i240a/submit/lab4/1-point$ ls
main.cc  point.cc  point.hh
aceylan1@g7-22:~/i240a/submit/lab4/1-point$ gd[Kedit point.cc
aceylan1@g7-22:~/i240a/submit/lab4/1-point$ gedit line,[K.cc

(gedit:114324): Gtk-[1;33mWARNING[0m **: [34m17:01:01.621[0m: Calling org.xfce.Session.Manager.Inhibit failed: GDBus.Error:org.freedesktop.DBus.Error.UnknownMethod: Method "Inhibit" with signature "susu" on interface "org.xfce.Session.Manager" doesn't exist

aceylan1@g7-22:~/i240a/submit/lab4/1-point$ gedit line.hh
aceylan1@g7-22:~/i240a/submit/lab4/1-point$ gedit main.cc
aceylan1@g7-22:~/i240a/submit/lab4/1-point$ gedit main.ccline.hh

(gedit:114404): Gtk-[1;33mWARNING[0m **: [34m17:10:06.492[0m: Calling org.xfce.Session.Manager.Inhibit failed: GDBus.Error:org.freedesktop.DBus.Error.UnknownMethod: Method "Inhibit" with signature "susu" on interface "org.xfce.Session.Manager" doesn't exist

aceylan1@g7-22:~/i240a/submit/lab4/1-point$ gdit [K[K[K[Kedit main .cc[K[K[K[K.cc
aceylan1@g7-22:~/i240a/submit/lab4/1-point$ gd[Kedit line.cc

(gedit:114514): Gtk-[1;33mWARNING[0m **: [34m17:27:41.479[0m: Calling org.xfce.Session.Manager.Inhibit failed: GDBus.Error:org.freedesktop.DBus.Error.UnknownMethod: Method "Inhibit" with signature "susu" on interface "org.xfce.Session.Manager" doesn't exist

aceylan1@g7-22:~/i240a/submit/lab4/1-point$ gedit line [K.hh

(gedit:114526): Gtk-[1;33mWARNING[0m **: [34m17:29:27.079[0m: Calling org.xfce.Session.Manager.Inhibit failed: GDBus.Error:org.freedesktop.DBus.Error.UnknownMethod: Method "Inhibit" with signature "susu" on interface "org.xfce.Session.Manager" doesn't exist

aceylan1@g7-22:~/i240a/submit/lab4/1-point$ gedit line.cc

(gedit:114539): Gtk-[1;33mWARNING[0m **: [34m17:30:58.400[0m: Calling org.xfce.Session.Manager.Inhibit failed: GDBus.Error:org.freedesktop.DBus.Error.UnknownMethod: Method "Inhibit" with signature "susu" on interface "org.xfce.Session.Manager" doesn't exist

aceylan1@g7-22:~/i240a/submit/lab4/1-point$ gedit main.cc

(gedit:114549): Gtk-[1;33mWARNING[0m **: [34m17:33:32.242[0m: Calling org.xfce.Session.Manager.Inhibit failed: GDBus.Error:org.freedesktop.DBus.Error.UnknownMethod: Method "Inhibit" with signature "susu" on interface "org.xfce.Session.Manager" doesn't exist

aceylan1@g7-22:~/i240a/submit/lab4/1-point$ makr [K[K [Ke -f 1-points/M[K[K[K[K[K[K[K[K[K[K[K ../Makefile 
g++ -MT point.o -MMD -MP -MF .deps/point.d -g -Wall -std=c++17 -c point.cc
g++ -MT main.o -MMD -MP -MF .deps/main.d -g -Wall -std=c++17 -c main.cc
[01m[Kmain.cc:[m[K In function ‘[01m[Kint main()[m[K’:
[01m[Kmain.cc:35:3:[m[K [01;31m[Kerror: [m[K‘[01m[Kline[m[K’ was not declared in this scope
   [01;31m[Kline[m[K line1 = line(points[0], points[1]);
   [01;31m[K^~~~[m[K
[01m[Kmain.cc:35:3:[m[K [01;36m[Knote: [m[Ksuggested alternative: ‘[01m[Kuint[m[K’
   [01;36m[Kline[m[K line1 = line(points[0], points[1]);
   [01;36m[K^~~~[m[K
   [32m[Kuint[m[K
[01m[Kmain.cc:36:7:[m[K [01;31m[Kerror: [m[Kexpected ‘[01m[K;[m[K’ before ‘[01m[Kline2[m[K’
   line[01;31m[K [m[K[32m[Kline2[m[K = line(points[2], points[3]);
       [01;31m[K^[m[K[32m[K~~~~~[m[K
       [32m[K;[m[K
[01m[Kmain.cc:37:14:[m[K [01;31m[Kerror: [m[K‘[01m[Kline1[m[K’ was not declared in this scope
   std::cout<<[01;31m[Kline1[m[K.toString()<<std::endl;
              [01;31m[K^~~~~[m[K
[01m[Kmain.cc:38:14:[m[K [01;31m[Kerror: [m[K‘[01m[Kline2[m[K’ was not declared in this scope
   std::cout<<[01;31m[Kline2[m[K.toString()<<std::endl;
              [01;31m[K^~~~~[m[K
make: *** [../Makefile:48: main.o] Error 1
aceylan1@g7-22:~/i240a/submit/lab4/1-point$ gedit L[Kline.hh

(gedit:114575): Gtk-[1;33mWARNING[0m **: [34m17:38:30.342[0m: Calling org.xfce.Session.Manager.Inhibit failed: GDBus.Error:org.freedesktop.DBus.Error.UnknownMethod: Method "Inhibit" with signature "susu" on interface "org.xfce.Session.Manager" doesn't exist

aceylan1@g7-22:~/i240a/submit/lab4/1-point$ gedit line.cc

(gedit:114583): Gtk-[1;33mWARNING[0m **: [34m17:39:02.455[0m: Calling org.xfce.Session.Manager.Inhibit failed: GDBus.Error:org.freedesktop.DBus.Error.UnknownMethod: Method "Inhibit" with signature "susu" on interface "org.xfce.Session.Manager" doesn't exist

aceylan1@g7-22:~/i240a/submit/lab4/1-point$ gedit line.cchhcc
\aceylan1@g7-22:~/i240a/submit/lab4/1-point$ \[KGEDIT [K[K[K[K[K[Kgedit line [K.hh

(gedit:114658): Gtk-[1;33mWARNING[0m **: [34m17:48:45.735[0m: Calling org.xfce.Session.Manager.Inhibit failed: GDBus.Error:org.freedesktop.DBus.Error.UnknownMethod: Method "Inhibit" with signature "susu" on interface "org.xfce.Session.Manager" doesn't exist

aceylan1@g7-22:~/i240a/submit/lab4/1-point$ ma[K[Kgedit line.hhcchhmake -f ../Makefile [7Pgedit main.cc

(gedit:114669): Gtk-[1;33mWARNING[0m **: [34m17:49:44.528[0m: Calling org.xfce.Session.Manager.Inhibit failed: GDBus.Error:org.freedesktop.DBus.Error.UnknownMethod: Method "Inhibit" with signature "susu" on interface "org.xfce.Session.Manager" doesn't exist

aceylan1@g7-22:~/i240a/submit/lab4/1-point$ gedit main.ccline.hhcchhmake -f ../Makefile 
g++ -MT main.o -MMD -MP -MF .deps/main.d -g -Wall -std=c++17 -c main.cc
In file included from [01m[Kmain.cc:2[m[K:
[01m[Kline.hh:11:19:[m[K [01;35m[Kwarning: [m[Kleft operand of comma operator has no effect [[01;35m[K-Wunused-value[m[K]
  line(Point x =(0,[01;35m[K0[m[K), Point y =(0,0)): x(x), y(y) {}
                   [01;35m[K^[m[K
[01m[Kline.hh:11:35:[m[K [01;35m[Kwarning: [m[Kleft operand of comma operator has no effect [[01;35m[K-Wunused-value[m[K]
  line(Point x =(0,0), Point y =(0,[01;35m[K0[m[K)): x(x), y(y) {}
                                   [01;35m[K^[m[K
g++ -MT line.o -MMD -MP -MF .deps/line.d -g -Wall -std=c++17 -c line.cc
In file included from [01m[Kline.cc:4[m[K:
[01m[Kline.hh:11:19:[m[K [01;35m[Kwarning: [m[Kleft operand of comma operator has no effect [[01;35m[K-Wunused-value[m[K]
  line(Point x =(0,[01;35m[K0[m[K), Point y =(0,0)): x(x), y(y) {}
                   [01;35m[K^[m[K
[01m[Kline.hh:11:35:[m[K [01;35m[Kwarning: [m[Kleft operand of comma operator has no effect [[01;35m[K-Wunused-value[m[K]
  line(Point x =(0,0), Point y =(0,[01;35m[K0[m[K)): x(x), y(y) {}
                                   [01;35m[K^[m[K
[01m[Kline.cc:7:1:[m[K [01;31m[Kerror: [m[K‘[01m[Klength[m[K’ declared as function returning a function
 [01;31m[Kdouble[m[K line::length() const(){
 [01;31m[K^~~~~~[m[K
[01m[Kline.cc:12:1:[m[K [01;31m[Kerror: [m[K‘[01m[KtoString[m[K’ declared as function returning a function
 [01;31m[Kstd[m[K::string line::toString() const(){
 [01;31m[K^~~[m[K
make: *** [../Makefile:48: line.o] Error 1
aceylan1@g7-22:~/i240a/submit/lab4/1-point$ make -f ../Makefile [7Pgedit main.ccline.hhcc

(gedit:114685): Gtk-[1;33mWARNING[0m **: [34m17:50:38.369[0m: Calling org.xfce.Session.Manager.Inhibit failed: GDBus.Error:org.freedesktop.DBus.Error.UnknownMethod: Method "Inhibit" with signature "susu" on interface "org.xfce.Session.Manager" doesn't exist

aceylan1@g7-22:~/i240a/submit/lab4/1-point$ gedit line.ccmake -f ../Makefile 
g++ -MT line.o -MMD -MP -MF .deps/line.d -g -Wall -std=c++17 -c line.cc
In file included from [01m[Kline.cc:4[m[K:
[01m[Kline.hh:11:19:[m[K [01;35m[Kwarning: [m[Kleft operand of comma operator has no effect [[01;35m[K-Wunused-value[m[K]
  line(Point x =(0,[01;35m[K0[m[K), Point y =(0,0)): x(x), y(y) {}
                   [01;35m[K^[m[K
[01m[Kline.hh:11:35:[m[K [01;35m[Kwarning: [m[Kleft operand of comma operator has no effect [[01;35m[K-Wunused-value[m[K]
  line(Point x =(0,0), Point y =(0,[01;35m[K0[m[K)): x(x), y(y) {}
                                   [01;35m[K^[m[K
[01m[Kline.cc:7:8:[m[K [01;31m[Kerror: [m[Kno declaration matches ‘[01m[Kdouble line::length() const[m[K’
 double [01;31m[Kline[m[K::length() const{
        [01;31m[K^~~~[m[K
In file included from [01m[Kline.cc:4[m[K:
[01m[Kline.hh:12:9:[m[K [01;36m[Knote: [m[Kcandidate is: ‘[01m[Kdouble line::length(const line&) const[m[K’
  double [01;36m[Klength[m[K(const line& other) const;
         [01;36m[K^~~~~~[m[K
[01m[Kline.hh:7:7:[m[K [01;36m[Knote: [m[K‘[01m[Kclass line[m[K’ defined here
 class [01;36m[Kline[m[K{
       [01;36m[K^~~~[m[K
[01m[Kline.cc:[m[K In member function ‘[01m[Kstd::__cxx11::string line::toString() const[m[K’:
[01m[Kline.cc:14:11:[m[K [01;31m[Kerror: [m[Kinvalid use of non-static member function ‘[01m[Kstd::__cxx11::string Point::toString() const[m[K’
  [01;31m[Ks << "(" << x.toString[m[K << "," << y.toString << ")" << "length =" << this -> distance(x,y);
  [01;31m[K~~~~~~~~~^~~~~~~~~~~~~[m[K
In file included from [01m[Kline.hh:5[m[K,
                 from [01m[Kline.cc:4[m[K:
[01m[Kpoint.hh:21:15:[m[K [01;36m[Knote: [m[Kdeclared here
   std::string [01;36m[KtoString[m[K() const;
               [01;36m[K^~~~~~~~[m[K
[01m[Kline.cc:14:78:[m[K [01;31m[Kerror: [m[K‘[01m[Kconst class line[m[K’ has no member named ‘[01m[Kdistance[m[K’
  << x.toString << "," << y.toString << ")" << "length =" << this -> [01;31m[Kdistance[m[K(x,y);
                                                                     [01;31m[K^~~~~~~~[m[K

make: *** [../Makefile:48: line.o] Error 1
aceylan1@g7-22:~/i240a/submit/lab4/1-point$ make -f ../Makefile [7Pgedit line.cc

(gedit:114696): Gtk-[1;33mWARNING[0m **: [34m17:51:25.591[0m: Calling org.xfce.Session.Manager.Inhibit failed: GDBus.Error:org.freedesktop.DBus.Error.UnknownMethod: Method "Inhibit" with signature "susu" on interface "org.xfce.Session.Manager" doesn't exist

aceylan1@g7-22:~/i240a/submit/lab4/1-point$ gedit line.ccmake -f ../Makefile 
g++ -MT line.o -MMD -MP -MF .deps/line.d -g -Wall -std=c++17 -c line.cc
In file included from [01m[Kline.cc:4[m[K:
[01m[Kline.hh:11:19:[m[K [01;35m[Kwarning: [m[Kleft operand of comma operator has no effect [[01;35m[K-Wunused-value[m[K]
  line(Point x =(0,[01;35m[K0[m[K), Point y =(0,0)): x(x), y(y) {}
                   [01;35m[K^[m[K
[01m[Kline.hh:11:35:[m[K [01;35m[Kwarning: [m[Kleft operand of comma operator has no effect [[01;35m[K-Wunused-value[m[K]
  line(Point x =(0,0), Point y =(0,[01;35m[K0[m[K)): x(x), y(y) {}
                                   [01;35m[K^[m[K
[01m[Kline.cc:7:8:[m[K [01;31m[Kerror: [m[Kno declaration matches ‘[01m[Kdouble line::length() const[m[K’
 double [01;31m[Kline[m[K::length() const{
        [01;31m[K^~~~[m[K
In file included from [01m[Kline.cc:4[m[K:
[01m[Kline.hh:12:9:[m[K [01;36m[Knote: [m[Kcandidate is: ‘[01m[Kdouble line::length(const line&) const[m[K’
  double [01;36m[Klength[m[K(const line& other) const;
         [01;36m[K^~~~~~[m[K
[01m[Kline.hh:7:7:[m[K [01;36m[Knote: [m[K‘[01m[Kclass line[m[K’ defined here
 class [01;36m[Kline[m[K{
       [01;36m[K^~~~[m[K
[01m[Kline.cc:[m[K In member function ‘[01m[Kstd::__cxx11::string line::toString() const[m[K’:
[01m[Kline.cc:14:11:[m[K [01;31m[Kerror: [m[Kinvalid use of non-static member function ‘[01m[Kstd::__cxx11::string Point::toString() const[m[K’
  [01;31m[Ks << "(" << x.toString[m[K << "," << y.toString << ")" << "length =" << this -> length();
  [01;31m[K~~~~~~~~~^~~~~~~~~~~~~[m[K
In file included from [01m[Kline.hh:5[m[K,
                 from [01m[Kline.cc:4[m[K:
[01m[Kpoint.hh:21:15:[m[K [01;36m[Knote: [m[Kdeclared here
   std::string [01;36m[KtoString[m[K() const;
               [01;36m[K^~~~~~~~[m[K
[01m[Kline.cc:14:85:[m[K [01;31m[Kerror: [m[Kno matching function for call to ‘[01m[Kline::length() const[m[K’
 (" << x.toString << "," << y.toString << ")" << "length =" << this -> length([01;31m[K)[m[K;
                                                                              [01;31m[K^[m[K

In file included from [01m[Kline.cc:4[m[K:
[01m[Kline.hh:12:9:[m[K [01;36m[Knote: [m[Kcandidate: ‘[01m[Kdouble line::length(const line&) const[m[K’
  double [01;36m[Klength[m[K(const line& other) const;
         [01;36m[K^~~~~~[m[K
[01m[Kline.hh:12:9:[m[K [01;36m[Knote: [m[K  candidate expects 1 argument, 0 provided
make: *** [../Makefile:48: line.o] Error 1
aceylan1@g7-22:~/i240a/submit/lab4/1-point$ make -f ../Makefile [7Pgedit line.cc

(gedit:114707): Gtk-[1;33mWARNING[0m **: [34m17:53:26.825[0m: Calling org.xfce.Session.Manager.Inhibit failed: GDBus.Error:org.freedesktop.DBus.Error.UnknownMethod: Method "Inhibit" with signature "susu" on interface "org.xfce.Session.Manager" doesn't exist

aceylan1@g7-22:~/i240a/submit/lab4/1-point$ gedit line.ccmake -f ../Makefile 
g++ -MT line.o -MMD -MP -MF .deps/line.d -g -Wall -std=c++17 -c line.cc
In file included from [01m[Kline.cc:4[m[K:
[01m[Kline.hh:11:19:[m[K [01;35m[Kwarning: [m[Kleft operand of comma operator has no effect [[01;35m[K-Wunused-value[m[K]
  line(Point x =(0,[01;35m[K0[m[K), Point y =(0,0)): x(x), y(y) {}
                   [01;35m[K^[m[K
[01m[Kline.hh:11:35:[m[K [01;35m[Kwarning: [m[Kleft operand of comma operator has no effect [[01;35m[K-Wunused-value[m[K]
  line(Point x =(0,0), Point y =(0,[01;35m[K0[m[K)): x(x), y(y) {}
                                   [01;35m[K^[m[K
[01m[Kline.cc:7:8:[m[K [01;31m[Kerror: [m[Kno declaration matches ‘[01m[Kdouble line::length() const[m[K’
 double [01;31m[Kline[m[K::length() const{
        [01;31m[K^~~~[m[K
In file included from [01m[Kline.cc:4[m[K:
[01m[Kline.hh:12:9:[m[K [01;36m[Knote: [m[Kcandidate is: ‘[01m[Kdouble line::length(const line&) const[m[K’
  double [01;36m[Klength[m[K(const line& other) const;
         [01;36m[K^~~~~~[m[K
[01m[Kline.hh:7:7:[m[K [01;36m[Knote: [m[K‘[01m[Kclass line[m[K’ defined here
 class [01;36m[Kline[m[K{
       [01;36m[K^~~~[m[K
[01m[Kline.cc:[m[K In member function ‘[01m[Kstd::__cxx11::string line::toString() const[m[K’:
[01m[Kline.cc:14:11:[m[K [01;31m[Kerror: [m[Kinvalid use of non-static member function ‘[01m[Kstd::__cxx11::string Point::toString() const[m[K’
  [01;31m[Ks << "(" << x.toString[m[K << ", " << y.toString << ")" << " length = " << this -> length();
  [01;31m[K~~~~~~~~~^~~~~~~~~~~~~[m[K
In file included from [01m[Kline.hh:5[m[K,
                 from [01m[Kline.cc:4[m[K:
[01m[Kpoint.hh:21:15:[m[K [01;36m[Knote: [m[Kdeclared here
   std::string [01;36m[KtoString[m[K() const;
               [01;36m[K^~~~~~~~[m[K
[01m[Kline.cc:14:88:[m[K [01;31m[Kerror: [m[Kno matching function for call to ‘[01m[Kline::length() const[m[K’
 << x.toString << ", " << y.toString << ")" << " length = " << this -> length([01;31m[K)[m[K;
                                                                              [01;31m[K^[m[K

In file included from [01m[Kline.cc:4[m[K:
[01m[Kline.hh:12:9:[m[K [01;36m[Knote: [m[Kcandidate: ‘[01m[Kdouble line::length(const line&) const[m[K’
  double [01;36m[Klength[m[K(const line& other) const;
         [01;36m[K^~~~~~[m[K
[01m[Kline.hh:12:9:[m[K [01;36m[Knote: [m[K  candidate expects 1 argument, 0 provided
make: *** [../Makefile:48: line.o] Error 1
aceylan1@g7-22:~/i240a/submit/lab4/1-point$ [Kaceylan1@g7-22:~/i240a/submit/lab4/1-point$ [Kaceylan1@g7-22:~/i240a/submit/lab4/1-point$ [Kaceylan1@g7-22:~/i240a/submit/lab4/1-point$ [Kaceylan1@g7-22:~/i240a/submit/lab4/1-point$ [Kaceylan1@g7-22:~/i240a/submit/lab4/1-point$ [Kaceylan1@g7-22:~/i240a/submit/lab4/1-point$ [Kaceylan1@g7-22:~/i240a/submit/lab4/1-point$ [Kaceylan1@g7-22:~/i240a/submit/lab4/1-point$ [Kaceylan1@g7-22:~/i240a/submit/lab4/1-point$ [Kaceylan1@g7-22:~/i240a/submit/lab4/1-point$ [Kaceylan1@g7-22:~/i240a/submit/lab4/1-point$ [Kaceylan1@g7-22:~/i240a/submit/lab4/1-point$ [Kaceylan1@g7-22:~/i240a/submit/lab4/1-point$ [Kaceylan1@g7-22:~/i240a/submit/lab4/1-point$ [Kaceylan1@g7-22:~/i240a/submit/lab4/1-point$ [Kaceylan1@g7-22:~/i240a/submit/lab4/1-point$ [Kaceylan1@g7-22:~/i240a/submit/lab4/1-point$ [Kaceylan1@g7-22:~/i240a/submit/lab4/1-point$ [Kaceylan1@g7-22:~/i240a/submit/lab4/1-point$ [Kaceylan1@g7-22:~/i240a/submit/lab4/1-point$ [Kaceylan1@g7-22:~/i240a/submit/lab4/1-point$ [Kaceylan1@g7-22:~/i240a/submit/lab4/1-point$ [Kaceylan1@g7-22:~/i240a/submit/lab4/1-point$ [Kaceylan1@g7-22:~/i240a/submit/lab4/1-point$ [Kaceylan1@g7-22:~/i240a/submit/lab4/1-point$ [Kaceylan1@g7-22:~/i240a/submit/lab4/1-point$ [Kaceylan1@g7-22:~/i240a/submit/lab4/1-point$ [Kaceylan1@g7-22:~/i240a/submit/lab4/1-point$ [Kaceylan1@g7-22:~/i240a/submit/lab4/1-point$ [Kaceylan1@g7-22:~/i240a/submit/lab4/1-point$ [Kaceylan1@g7-22:~/i240a/submit/lab4/1-point$ [Kaceylan1@g7-22:~/i240a/submit/lab4/1-point$ [Kaceylan1@g7-22:~/i240a/submit/lab4/1-point$ [Kaceylan1@g7-22:~/i240a/submit/lab4/1-point$ gedit line.gg[K[Khh

(gedit:114723): Gtk-[1;33mWARNING[0m **: [34m17:55:03.125[0m: Calling org.xfce.Session.Manager.Inhibit failed: GDBus.Error:org.freedesktop.DBus.Error.UnknownMethod: Method "Inhibit" with signature "susu" on interface "org.xfce.Session.Manager" doesn't exist

aceylan1@g7-22:~/i240a/submit/lab4/1-point$ gedit line.hhmake -f ../Makefile 
g++ -MT main.o -MMD -MP -MF .deps/main.d -g -Wall -std=c++17 -c main.cc
In file included from [01m[Kmain.cc:2[m[K:
[01m[Kline.hh:11:19:[m[K [01;35m[Kwarning: [m[Kleft operand of comma operator has no effect [[01;35m[K-Wunused-value[m[K]
  line(Point x =(0,[01;35m[K0[m[K), Point y =(0,0)): x(x), y(y) {}
                   [01;35m[K^[m[K
[01m[Kline.hh:11:35:[m[K [01;35m[Kwarning: [m[Kleft operand of comma operator has no effect [[01;35m[K-Wunused-value[m[K]
  line(Point x =(0,0), Point y =(0,[01;35m[K0[m[K)): x(x), y(y) {}
                                   [01;35m[K^[m[K
g++ -MT line.o -MMD -MP -MF .deps/line.d -g -Wall -std=c++17 -c line.cc
In file included from [01m[Kline.cc:4[m[K:
[01m[Kline.hh:11:19:[m[K [01;35m[Kwarning: [m[Kleft operand of comma operator has no effect [[01;35m[K-Wunused-value[m[K]
  line(Point x =(0,[01;35m[K0[m[K), Point y =(0,0)): x(x), y(y) {}
                   [01;35m[K^[m[K
[01m[Kline.hh:11:35:[m[K [01;35m[Kwarning: [m[Kleft operand of comma operator has no effect [[01;35m[K-Wunused-value[m[K]
  line(Point x =(0,0), Point y =(0,[01;35m[K0[m[K)): x(x), y(y) {}
                                   [01;35m[K^[m[K
[01m[Kline.cc:[m[K In member function ‘[01m[Kstd::__cxx11::string line::toString() const[m[K’:
[01m[Kline.cc:14:11:[m[K [01;31m[Kerror: [m[Kinvalid use of non-static member function ‘[01m[Kstd::__cxx11::string Point::toString() const[m[K’
  [01;31m[Ks << "(" << x.toString[m[K << ", " << y.toString << ")" << " length = " << this -> length();
  [01;31m[K~~~~~~~~~^~~~~~~~~~~~~[m[K
In file included from [01m[Kline.hh:5[m[K,
                 from [01m[Kline.cc:4[m[K:
[01m[Kpoint.hh:21:15:[m[K [01;36m[Knote: [m[Kdeclared here
   std::string [01;36m[KtoString[m[K() const;
               [01;36m[K^~~~~~~~[m[K
make: *** [../Makefile:48: line.o] Error 1
aceylan1@g7-22:~/i240a/submit/lab4/1-point$ make -f ../Makefile [7Pgedit line.hh
aceylan1@g7-22:~/i240a/submit/lab4/1-point$ gedit main.cc
aceylan1@g7-22:~/i240a/submit/lab4/1-point$ gedit main.ccline.hhmake -f ../Makefile 
g++ -MT main.o -MMD -MP -MF .deps/main.d -g -Wall -std=c++17 -c main.cc
In file included from [01m[Kmain.cc:2[m[K:
[01m[Kline.hh:11:19:[m[K [01;35m[Kwarning: [m[Kleft operand of comma operator has no effect [[01;35m[K-Wunused-value[m[K]
  line(Point x =(0,[01;35m[K0[m[K), Point y =(0,0)): x(x), y(y) {}
                   [01;35m[K^[m[K
[01m[Kline.hh:11:35:[m[K [01;35m[Kwarning: [m[Kleft operand of comma operator has no effect [[01;35m[K-Wunused-value[m[K]
  line(Point x =(0,0), Point y =(0,[01;35m[K0[m[K)): x(x), y(y) {}
                                   [01;35m[K^[m[K
g++ -MT line.o -MMD -MP -MF .deps/line.d -g -Wall -std=c++17 -c line.cc
In file included from [01m[Kline.cc:4[m[K:
[01m[Kline.hh:11:19:[m[K [01;35m[Kwarning: [m[Kleft operand of comma operator has no effect [[01;35m[K-Wunused-value[m[K]
  line(Point x =(0,[01;35m[K0[m[K), Point y =(0,0)): x(x), y(y) {}
                   [01;35m[K^[m[K
[01m[Kline.hh:11:35:[m[K [01;35m[Kwarning: [m[Kleft operand of comma operator has no effect [[01;35m[K-Wunused-value[m[K]
  line(Point x =(0,0), Point y =(0,[01;35m[K0[m[K)): x(x), y(y) {}
                                   [01;35m[K^[m[K
[01m[Kline.cc:[m[K In member function ‘[01m[Kstd::__cxx11::string line::toString() const[m[K’:
[01m[Kline.cc:14:11:[m[K [01;31m[Kerror: [m[Kinvalid use of non-static member function ‘[01m[Kstd::__cxx11::string Point::toString() const[m[K’
  [01;31m[Ks << "(" << x.toString[m[K << ", " << y.toString << ")" << " length = " << this -> length();
  [01;31m[K~~~~~~~~~^~~~~~~~~~~~~[m[K
In file included from [01m[Kline.hh:5[m[K,
                 from [01m[Kline.cc:4[m[K:
[01m[Kpoint.hh:21:15:[m[K [01;36m[Knote: [m[Kdeclared here
   std::string [01;36m[KtoString[m[K() const;
               [01;36m[K^~~~~~~~[m[K
make: *** [../Makefile:48: line.o] Error 1
aceylan1@g7-22:~/i240a/submit/lab4/1-point$ ./mian[K[K[Kain
bash: ./main: No such file or directory
aceylan1@g7-22:~/i240a/submit/lab4/1-point$ ls
line.cc  line.hh  main.cc  main.o  point.cc  point.hh  point.o
aceylan1@g7-22:~/i240a/submit/lab4/1-point$ ls./mainmake -f ../Makefile ./main[K[K[K[K[K[K[Kgdi[K[Kedit line/[K.cc

(gedit:114761): Gtk-[1;33mWARNING[0m **: [34m17:58:37.390[0m: Calling org.xfce.Session.Manager.Inhibit failed: GDBus.Error:org.freedesktop.DBus.Error.UnknownMethod: Method "Inhibit" with signature "susu" on interface "org.xfce.Session.Manager" doesn't exist

aceylan1@g7-22:~/i240a/submit/lab4/1-point$ gedit line.ccls[K./mainmake -f ../Makefile 
g++ -MT line.o -MMD -MP -MF .deps/line.d -g -Wall -std=c++17 -c line.cc
In file included from [01m[Kline.cc:4[m[K:
[01m[Kline.hh:11:19:[m[K [01;35m[Kwarning: [m[Kleft operand of comma operator has no effect [[01;35m[K-Wunused-value[m[K]
  line(Point x =(0,[01;35m[K0[m[K), Point y =(0,0)): x(x), y(y) {}
                   [01;35m[K^[m[K
[01m[Kline.hh:11:35:[m[K [01;35m[Kwarning: [m[Kleft operand of comma operator has no effect [[01;35m[K-Wunused-value[m[K]
  line(Point x =(0,0), Point y =(0,[01;35m[K0[m[K)): x(x), y(y) {}
                                   [01;35m[K^[m[K
g++ point.o main.o line.o -o main
cat </dev/null >.gitignore
echo .deps >.gitignore
for t in main point.o main.o line.o; do echo $t >>.gitignore; done
aceylan1@g7-22:~/i240a/submit/lab4/1-point$ ./main
((0, 0), (3, 4)) length = 5
((1, 1), (4, 5)) length = 5
distance from (0, 0) to (3, 4) is 5
distance from (0, 0) to (1, 1) is 1.41421
distance from (0, 0) to (4, 5) is 6.40312
distance from (3, 4) to (1, 1) is 3.60555
distance from (3, 4) to (4, 5) is 1.41421
distance from (1, 1) to (4, 5) is 5

sizeof(double) = 8
sizeof(Point) = 16
aceylan1@g7-22:~/i240a/submit/lab4/1-point$ cd.
bash: cd.: command not found
aceylan1@g7-22:~/i240a/submit/lab4/1-point$ cd ..
aceylan1@g7-22:~/i240a/submit/lab4$ ls
1-point  2-shape  3-expr  lab4.LOG  Makefile
aceylan1@g7-22:~/i240a/submit/lab4$ cd 2*
aceylan1@g7-22:~/i240a/submit/lab4/2-shape$ ls
main.cc  point.cc  point.hh  shapes.hh	tostring.cc  tostring.hh
aceylan1@g7-22:~/i240a/submit/lab4/2-shape$ make -f ../Makefile
g++ -MT tostring.o -MMD -MP -MF .deps/tostring.d -g -Wall -std=c++17 -c tostring.cc
g++ -MT point.o -MMD -MP -MF .deps/point.d -g -Wall -std=c++17 -c point.cc
lg++ -MT main.o -MMD -MP -MF .deps/main.d -g -Wall -std=c++17 -c main.cc
g++ tostring.o point.o main.o -o main
cat </dev/null >.gitignore
echo .deps >.gitignore
for t in main tostring.o point.o main.o; do echo $t >>.gitignore; done
aceylan1@g7-22:~/i240a/submit/lab4/2-shape$ lls
bash: lls: command not found
aceylan1@g7-22:~/i240a/submit/lab4/2-shape$ ls
main  main.cc  main.o  point.cc  point.hh  point.o  shapes.hh  tostring.cc  tostring.hh  tostring.o
aceylan1@g7-22:~/i240a/submit/lab4/2-shape$ ./main
Circle[(0, 0), 1] perimeter: 6.28319
Rectangle[(1, 1), (4, 5)] perimeter: 14
Circle[(1, 1), 2] perimeter: 12.5664
Rectangle[(0, 0), (5, 4)] perimeter: 18

sizeof(double) = 8
sizeof(Point) = 24

sizeof(ToString) = 8
sizeof(Shape) = 8
sizeof(Circle) = 40
sizeof(Rectangle) = 56

aceylan1@g7-22:~/i240a/submit/lab4/2-shape$ [Kaceylan1@g7-22:~/i240a/submit/lab4/2-shape$ [Kaceylan1@g7-22:~/i240a/submit/lab4/2-shape$ [Kaceylan1@g7-22:~/i240a/submit/lab4/2-shape$ [Kaceylan1@g7-22:~/i240a/submit/lab4/2-shape$ [Kaceylan1@g7-22:~/i240a/submit/lab4/2-shape$ [Kaceylan1@g7-22:~/i240a/submit/lab4/2-shape$ [Kaceylan1@g7-22:~/i240a/submit/lab4/2-shape$ [Kaceylan1@g7-22:~/i240a/submit/lab4/2-shape$ [Kaceylan1@g7-22:~/i240a/submit/lab4/2-shape$ [Kaceylan1@g7-22:~/i240a/submit/lab4/2-shape$ [Kaceylan1@g7-22:~/i240a/submit/lab4/2-shape$ [Kaceylan1@g7-22:~/i240a/submit/lab4/2-shape$ [Kaceylan1@g7-22:~/i240a/submit/lab4/2-shape$ [Kaceylan1@g7-22:~/i240a/submit/lab4/2-shape$ [Kaceylan1@g7-22:~/i240a/submit/lab4/2-shape$ [Kaceylan1@g7-22:~/i240a/submit/lab4/2-shape$ [Kaceylan1@g7-22:~/i240a/submit/lab4/2-shape$ [Kaceylan1@g7-22:~/i240a/submit/lab4/2-shape$ [Kaceylan1@g7-22:~/i240a/submit/lab4/2-shape$ [Kaceylan1@g7-22:~/i240a/submit/lab4/2-shape$ [Kaceylan1@g7-22:~/i240a/submit/lab4/2-shape$ [Kaceylan1@g7-22:~/i240a/submit/lab4/2-shape$ [Kaceylan1@g7-22:~/i240a/submit/lab4/2-shape$ [Kaceylan1@g7-22:~/i240a/submit/lab4/2-shape$ gedit shapes.hh

(gedit:114827): Gtk-[1;33mWARNING[0m **: [34m18:03:11.749[0m: Calling org.xfce.Session.Manager.Inhibit failed: GDBus.Error:org.freedesktop.DBus.Error.UnknownMethod: Method "Inhibit" with signature "susu" on interface "org.xfce.Session.Manager" doesn't exist

aceylan1@g7-22:~/i240a/submit/lab4/2-shape$ gedit main.cc
aceylan1@g7-22:~/i240a/submit/lab4/2-shape$ gedit main.ccshapes.hh

(gedit:115819): Gtk-[1;33mWARNING[0m **: [34m18:16:19.388[0m: Calling org.xfce.Session.Manager.Inhibit failed: GDBus.Error:org.freedesktop.DBus.Error.UnknownMethod: Method "Inhibit" with signature "susu" on interface "org.xfce.Session.Manager" doesn't exist

aceylan1@g7-22:~/i240a/submit/lab4/2-shape$ gedit shapes.hh[2Pmain.cc

(gedit:115832): Gtk-[1;33mWARNING[0m **: [34m18:18:41.568[0m: Calling org.xfce.Session.Manager.Inhibit failed: GDBus.Error:org.freedesktop.DBus.Error.UnknownMethod: Method "Inhibit" with signature "susu" on interface "org.xfce.Session.Manager" doesn't exist

aceylan1@g7-22:~/i240a/submit/lab4/2-shape$ gedit main.ccshapes.hh[2Pmain.ccshapes.hh[9P./main[4Plslsmake -f ../Makefile
g++ -MT main.o -MMD -MP -MF .deps/main.d -g -Wall -std=c++17 -c main.cc
g++ tostring.o point.o main.o -o main
cat </dev/null >.gitignore
echo .deps >.gitignore
for t in main tostring.o point.o main.o; do echo $t >>.gitignore; done
aceylan1@g7-22:~/i240a/submit/lab4/2-shape$ ./main
Circle[(0, 0), 1] perimeter: 6.28319area: 1
Rectangle[(1, 1), (4, 5)] perimeter: 14area: 12
Circle[(1, 1), 2] perimeter: 12.5664area: 4
Rectangle[(0, 0), (5, 4)] perimeter: 18area: 20

sizeof(double) = 8
sizeof(Point) = 24

sizeof(ToString) = 8
sizeof(Shape) = 8
sizeof(Circle) = 40
sizeof(Rectangle) = 56

aceylan1@g7-22:~/i240a/submit/lab4/2-shape$ \[Kcd
aceylan1@g7-22:~$ cd cs240[K[K[Ki240a
bash: cd: csi240a: No such file or directory
aceylan1@g7-22:~$ cd i3[K240a
aceylan1@g7-22:~/i240a$ cd submit 
aceylan1@g7-22:~/i240a/submit$ cd lab4
aceylan1@g7-22:~/i240a/submit/lab4$ ls
1-point  2-shape  3-expr  lab4.LOG  Makefile
aceylan1@g7-22:~/i240a/submit/lab4$ cd 3*
aceylan1@g7-22:~/i240a/submit/lab4/3-expr$ 
aceylan1@g7-22:~/i240a/submit/lab4/3-expr$ ls
expr.cc  main.cc   parse.hh	tostring.hh
expr.hh  parse.cc  tostring.cc
aceylan1@g7-22:~/i240a/submit/lab4/3-expr$ cd expr.cc
bash: cd: expr.cc: Not a directory
aceylan1@g7-22:~/i240a/submit/lab4/3-expr$ cd exoer[K[K[K[K[K[K[K[Kgedit.[K expr.cc
aceylan1@g7-22:~/i240a/submit/lab4/3-expr$ gedit espr[K[K[Kxpr.hh

(gedit:115883): Gtk-[1;33mWARNING[0m **: [34m18:30:01.323[0m: Calling org.xfce.Session.Manager.Inhibit failed: GDBus.Error:org.freedesktop.DBus.Error.UnknownMethod: Method "Inhibit" with signature "susu" on interface "org.xfce.Session.Manager" doesn't exist

aceylan1@g7-22:~/i240a/submit/lab4/3-expr$ ls
expr.cc  main.cc   parse.hh	tostring.hh
expr.hh  parse.cc  tostring.cc
aceylan1@g7-22:~/i240a/submit/lab4/3-expr$ gedit [K[K[K[K[K[Kgre[K[K[Kgedit parse.cc
aceylan1@g7-22:~/i240a/submit/lab4/3-expr$ gedit toString.cc
aceylan1@g7-22:~/i240a/submit/lab4/3-expr$ gedit main.cc

(gedit:115963): Gtk-[1;33mWARNING[0m **: [34m18:40:19.985[0m: Calling org.xfce.Session.Manager.Inhibit failed: GDBus.Error:org.freedesktop.DBus.Error.UnknownMethod: Method "Inhibit" with signature "susu" on interface "org.xfce.Session.Manager" doesn't exist

aceylan1@g7-22:~/i240a/submit/lab4/3-expr$ gedit main.cctoString.cc[3Pparse.ccls[Kgedit expr.hhcc[3Pcd[C[C[C[C[C[C[C[Cls[Kcd 3*[3Plscd lab4submit [2Pi240acsi240a[K./mainmake -f ../Makefile[6Pgedit main.ccmake -f ../Makefile
g++ -MT tostring.o -MMD -MP -MF .deps/tostring.d -g -Wall -std=c++17 -c tostring.cc
g++ -MT main.o -MMD -MP -MF .deps/main.d -g -Wall -std=c++17 -c main.cc
In file included from [01m[Kmain.cc:1[m[K:
[01m[Kexpr.hh:60:11:[m[K [01;31m[Kerror: [m[Kexpected unqualified-id before ‘[01m[Kint[m[K’
   IntExpr([01;31m[Kint[m[K val, Private x) : value(val){}
           [01;31m[K^~~[m[K
[01m[Kexpr.hh:60:11:[m[K [01;31m[Kerror: [m[Kexpected ‘[01m[K)[m[K’ before ‘[01m[Kint[m[K’
   IntExpr[34m[K([m[K[01;31m[Ki[m[K[32m[Knt[m[K val, Private x) : value(val){}
          [34m[K~[m[K[01;31m[K^[m[K[32m[K~~[m[K
           [32m[K)[m[K
[01m[Kexpr.hh:[m[K In member function ‘[01m[Kint AddExpr::eval() const[m[K’:
[01m[Kexpr.hh:56:15:[m[K [01;31m[Kerror: [m[K‘[01m[Kusing element_type = class Expr[m[K’ {aka ‘[01m[Kclass Expr[m[K’} has no member named ‘[01m[Keval[m[K’
  return left->[01;31m[Keval[m[K()+right->eval();
               [01;31m[K^~~~[m[K
[01m[Kexpr.hh:56:29:[m[K [01;31m[Kerror: [m[K‘[01m[Kusing element_type = class Expr[m[K’ {aka ‘[01m[Kclass Expr[m[K’} has no member named ‘[01m[Keval[m[K’
  return left->eval()+right->[01;31m[Keval[m[K();
                             [01;31m[K^~~~[m[K
[01m[Kexpr.hh:[m[K At global scope:
[01m[Kexpr.hh:64:42:[m[K [01;31m[Kerror: [m[K‘[01m[KPrivate[m[K’ has not been declared
   AddExpr(ExprPtr& left, ExprPtr& right, [01;31m[KPrivate[m[K x) :
                                          [01;31m[K^~~~~~~[m[K
[01m[Kexpr.hh:64:51:[m[K [01;31m[Kerror: [m[KISO C++ forbids declaration of ‘[01m[KAddExpr[m[K’ with no type [[01;31m[K-fpermissive[m[K]
   AddExpr(ExprPtr& left, ExprPtr& right, Private x[01;31m[K)[m[K :
                                                   [01;31m[K^[m[K
[01m[Kexpr.hh:[m[K In function ‘[01m[Kint AddExpr(ExprPtr&, ExprPtr&, int)[m[K’:
[01m[Kexpr.hh:65:5:[m[K [01;31m[Kerror: [m[Konly constructors take member initializers
     [01;31m[Kleft[m[K(left), right(right) {
     [01;31m[K^~~~[m[K
[01m[Kexpr.hh:66:3:[m[K [01;35m[Kwarning: [m[Kno return statement in function returning non-void [[01;35m[K-Wreturn-type[m[K]
   [01;35m[K}[m[K
   [01;35m[K^[m[K
[01m[Kexpr.hh:[m[K At global scope:
[01m[Kexpr.hh:67:1:[m[K [01;31m[Kerror: [m[Kexpected declaration before ‘[01m[K}[m[K’ token
 [01;31m[K}[m[K; //AddExpr
 [01;31m[K^[m[K
In file included from [01m[K/usr/include/x86_64-linux-gnu/c++/8/bits/c++allocator.h:33[m[K,
                 from [01m[K/usr/include/c++/8/bits/allocator.h:46[m[K,
                 from [01m[K/usr/include/c++/8/string:41[m[K,
                 from [01m[K/usr/include/c++/8/bits/locale_classes.h:40[m[K,
                 from [01m[K/usr/include/c++/8/bits/ios_base.h:41[m[K,
                 from [01m[K/usr/include/c++/8/ios:42[m[K,
                 from [01m[K/usr/include/c++/8/ostream:38[m[K,
                 from [01m[K/usr/include/c++/8/iostream:39[m[K,
                 from [01m[Ktostring.hh:4[m[K,
                 from [01m[Kexpr.hh:4[m[K,
                 from [01m[Kmain.cc:1[m[K:
/usr/include/c++/8/ext/new_allocator.h: In instantiation of ‘[01m[Kvoid __gnu_cxx::new_allocator<_Tp>::construct(_Up*, _Args&& ...) [with _Up = AddExpr; _Args = {std::shared_ptr<Expr>&, std::shared_ptr<Expr>&, AddExpr::Private}; _Tp = AddExpr][m[K’:
[01m[K/usr/include/c++/8/bits/alloc_traits.h:475:4:[m[K   required from ‘[01m[Kstatic void std::allocator_traits<std::allocator<_CharT> >::construct(std::allocator_traits<std::allocator<_CharT> >::allocator_type&, _Up*, _Args&& ...) [with _Up = AddExpr; _Args = {std::shared_ptr<Expr>&, std::shared_ptr<Expr>&, AddExpr::Private}; _Tp = AddExpr; std::allocator_traits<std::allocator<_CharT> >::allocator_type = std::allocator<AddExpr>][m[K’
[01m[K/usr/include/c++/8/bits/shared_ptr_base.h:545:39:[m[K   required from ‘[01m[Kstd::_Sp_counted_ptr_inplace<_Tp, _Alloc, _Lp>::_Sp_counted_ptr_inplace(_Alloc, _Args&& ...) [with _Args = {std::shared_ptr<Expr>&, std::shared_ptr<Expr>&, AddExpr::Private}; _Tp = AddExpr; _Alloc = std::allocator<AddExpr>; __gnu_cxx::_Lock_policy _Lp = (__gnu_cxx::_Lock_policy)2][m[K’
[01m[K/usr/include/c++/8/bits/shared_ptr_base.h:677:16:[m[K   required from ‘[01m[Kstd::__shared_count<_Lp>::__shared_count(_Tp*&, std::_Sp_alloc_shared_tag<_Alloc>, _Args&& ...) [with _Tp = AddExpr; _Alloc = std::allocator<AddExpr>; _Args = {std::shared_ptr<Expr>&, std::shared_ptr<Expr>&, AddExpr::Private}; __gnu_cxx::_Lock_policy _Lp = (__gnu_cxx::_Lock_policy)2][m[K’
[01m[K/usr/include/c++/8/bits/shared_ptr_base.h:1342:71:[m[K   required from ‘[01m[Kstd::__shared_ptr<_Tp, _Lp>::__shared_ptr(std::_Sp_alloc_shared_tag<_Tp>, _Args&& ...) [with _Alloc = std::allocator<AddExpr>; _Args = {std::shared_ptr<Expr>&, std::shared_ptr<Expr>&, AddExpr::Private}; _Tp = AddExpr; __gnu_cxx::_Lock_policy _Lp = (__gnu_cxx::_Lock_policy)2][m[K’
[01m[K/usr/include/c++/8/bits/shared_ptr.h:359:59:[m[K   required from ‘[01m[Kstd::shared_ptr<_Tp>::shared_ptr(std::_Sp_alloc_shared_tag<_Tp>, _Args&& ...) [with _Alloc = std::allocator<AddExpr>; _Args = {std::shared_ptr<Expr>&, std::shared_ptr<Expr>&, AddExpr::Private}; _Tp = AddExpr][m[K’
[01m[K/usr/include/c++/8/bits/shared_ptr.h:705:14:[m[K   required from ‘[01m[Kstd::shared_ptr<_Tp> std::allocate_shared(const _Alloc&, _Args&& ...) [with _Tp = AddExpr; _Alloc = std::allocator<AddExpr>; _Args = {std::shared_ptr<Expr>&, std::shared_ptr<Expr>&, AddExpr::Private}][m[K’
[01m[K/usr/include/c++/8/bits/shared_ptr.h:721:39:[m[K   required from ‘[01m[Kstd::shared_ptr<_Tp> std::make_shared(_Args&& ...) [with _Tp = AddExpr; _Args = {std::shared_ptr<Expr>&, std::shared_ptr<Expr>&, AddExpr::Private}][m[K’
[01m[Kexpr.hh:53:63:[m[K   required from here
[01m[K/usr/include/c++/8/ext/new_allocator.h:136:4:[m[K [01;31m[Kerror: [m[Kno matching function for call to ‘[01m[KAddExpr::AddExpr(std::shared_ptr<Expr>&, std::shared_ptr<Expr>&, AddExpr::Private)[m[K’
  { [01;31m[K::new((void *)__p) _Up(std::forward<_Args>(__args)...)[m[K; }
    [01;31m[K^~~~~~~~~~~~~~~~~~~~~~~~~~~~~~~~~~~~~~~~~~~~~~~~~~~~~~[m[K
In file included from [01m[Kmain.cc:1[m[K:
[01m[Kexpr.hh:44:7:[m[K [01;36m[Knote: [m[Kcandidate: ‘[01m[Kconstexpr AddExpr::AddExpr()[m[K’
 class [01;36m[KAddExpr[m[K : public Expr {
       [01;36m[K^~~~~~~[m[K
[01m[Kexpr.hh:44:7:[m[K [01;36m[Knote: [m[K  candidate expects 0 arguments, 3 provided
[01m[Kexpr.hh:44:7:[m[K [01;36m[Knote: [m[Kcandidate: ‘[01m[KAddExpr::AddExpr(const AddExpr&)[m[K’
[01m[Kexpr.hh:44:7:[m[K [01;36m[Knote: [m[K  candidate expects 1 argument, 3 provided
[01m[Kexpr.hh:44:7:[m[K [01;36m[Knote: [m[Kcandidate: ‘[01m[KAddExpr::AddExpr(AddExpr&&)[m[K’
[01m[Kexpr.hh:44:7:[m[K [01;36m[Knote: [m[K  candidate expects 1 argument, 3 provided
make: *** [../Makefile:48: main.o] Error 1
aceylan1@g7-22:~/i240a/submit/lab4/3-expr$ [Kaceylan1@g7-22:~/i240a/submit/lab4/3-expr$ [Kaceylan1@g7-22:~/i240a/submit/lab4/3-expr$ [Kaceylan1@g7-22:~/i240a/submit/lab4/3-expr$ [Kaceylan1@g7-22:~/i240a/submit/lab4/3-expr$ [Kaceylan1@g7-22:~/i240a/submit/lab4/3-expr$ [Kaceylan1@g7-22:~/i240a/submit/lab4/3-expr$ [Kaceylan1@g7-22:~/i240a/submit/lab4/3-expr$ [Kaceylan1@g7-22:~/i240a/submit/lab4/3-expr$ [Kaceylan1@g7-22:~/i240a/submit/lab4/3-expr$ [Kaceylan1@g7-22:~/i240a/submit/lab4/3-expr$ [Kaceylan1@g7-22:~/i240a/submit/lab4/3-expr$ [Kaceylan1@g7-22:~/i240a/submit/lab4/3-expr$ [Kaceylan1@g7-22:~/i240a/submit/lab4/3-expr$ [Kaceylan1@g7-22:~/i240a/submit/lab4/3-expr$ [Kaceylan1@g7-22:~/i240a/submit/lab4/3-expr$ [Kaceylan1@g7-22:~/i240a/submit/lab4/3-expr$ [Kaceylan1@g7-22:~/i240a/submit/lab4/3-expr$ [Kaceylan1@g7-22:~/i240a/submit/lab4/3-expr$ [Kaceylan1@g7-22:~/i240a/submit/lab4/3-expr$ [Kaceylan1@g7-22:~/i240a/submit/lab4/3-expr$ [Kaceylan1@g7-22:~/i240a/submit/lab4/3-expr$ [Kaceylan1@g7-22:~/i240a/submit/lab4/3-expr$ [Kaceylan1@g7-22:~/i240a/submit/lab4/3-expr$ [Kaceylan1@g7-22:~/i240a/submit/lab4/3-expr$ [Kaceylan1@g7-22:~/i240a/submit/lab4/3-expr$ [Kaceylan1@g7-22:~/i240a/submit/lab4/3-expr$ [Kaceylan1@g7-22:~/i240a/submit/lab4/3-expr$ [Kaceylan1@g7-22:~/i240a/submit/lab4/3-expr$ [Kaceylan1@g7-22:~/i240a/submit/lab4/3-expr$ ls
expr.cc  expr.hh  main.cc  parse.cc  parse.hh  tostring.cc  tostring.hh  tostring.o
aceylan1@g7-22:~/i240a/submit/lab4/3-expr$ gedit expr.cvc[K[Kc
aceylan1@g7-22:~/i240a/submit/lab4/3-expr$ gedit parse.cc
aceylan1@g7-22:~/i240a/submit/lab4/3-expr$ gedit [K.expr[K[K[K[K[K expr.hh

(gedit:115997): Gtk-[1;33mWARNING[0m **: [34m18:45:29.373[0m: Calling org.xfce.Session.Manager.Inhibit failed: GDBus.Error:org.freedesktop.DBus.Error.UnknownMethod: Method "Inhibit" with signature "susu" on interface "org.xfce.Session.Manager" doesn't exist

aceylan1@g7-22:~/i240a/submit/lab4/3-expr$ gedit expr.hhparse.cc[1Pexpr.ccls[Kmake -f ../Makefile
g++ -MT main.o -MMD -MP -MF .deps/main.d -g -Wall -std=c++17 -c main.cc
In file included from [01m[Kmain.cc:1[m[K:
[01m[Kexpr.hh:62:11:[m[K [01;31m[Kerror: [m[Kexpected unqualified-id before ‘[01m[Kint[m[K’
   IntExpr([01;31m[Kint[m[K val, Private x) : value(val){}
           [01;31m[K^~~[m[K
[01m[Kexpr.hh:62:11:[m[K [01;31m[Kerror: [m[Kexpected ‘[01m[K)[m[K’ before ‘[01m[Kint[m[K’
   IntExpr[34m[K([m[K[01;31m[Ki[m[K[32m[Knt[m[K val, Private x) : value(val){}
          [34m[K~[m[K[01;31m[K^[m[K[32m[K~~[m[K
           [32m[K)[m[K
[01m[Kexpr.hh:66:42:[m[K [01;31m[Kerror: [m[K‘[01m[KPrivate[m[K’ has not been declared
   AddExpr(ExprPtr& left, ExprPtr& right, [01;31m[KPrivate[m[K x) :
                                          [01;31m[K^~~~~~~[m[K
[01m[Kexpr.hh:66:51:[m[K [01;31m[Kerror: [m[KISO C++ forbids declaration of ‘[01m[KAddExpr[m[K’ with no type [[01;31m[K-fpermissive[m[K]
   AddExpr(ExprPtr& left, ExprPtr& right, Private x[01;31m[K)[m[K :
                                                   [01;31m[K^[m[K
[01m[Kexpr.hh:[m[K In function ‘[01m[Kint AddExpr(ExprPtr&, ExprPtr&, int)[m[K’:
[01m[Kexpr.hh:67:5:[m[K [01;31m[Kerror: [m[Konly constructors take member initializers
     [01;31m[Kleft[m[K(left), right(right) {
     [01;31m[K^~~~[m[K
[01m[Kexpr.hh:68:3:[m[K [01;35m[Kwarning: [m[Kno return statement in function returning non-void [[01;35m[K-Wreturn-type[m[K]
   [01;35m[K}[m[K
   [01;35m[K^[m[K
[01m[Kexpr.hh:[m[K At global scope:
[01m[Kexpr.hh:69:1:[m[K [01;31m[Kerror: [m[Kexpected declaration before ‘[01m[K}[m[K’ token
 [01;31m[K}[m[K; //AddExpr
 [01;31m[K^[m[K
In file included from [01m[K/usr/include/x86_64-linux-gnu/c++/8/bits/c++allocator.h:33[m[K,
                 from [01m[K/usr/include/c++/8/bits/allocator.h:46[m[K,
                 from [01m[K/usr/include/c++/8/string:41[m[K,
                 from [01m[K/usr/include/c++/8/bits/locale_classes.h:40[m[K,
                 from [01m[K/usr/include/c++/8/bits/ios_base.h:41[m[K,
                 from [01m[K/usr/include/c++/8/ios:42[m[K,
                 from [01m[K/usr/include/c++/8/ostream:38[m[K,
                 from [01m[K/usr/include/c++/8/iostream:39[m[K,
                 from [01m[Ktostring.hh:4[m[K,
                 from [01m[Kexpr.hh:4[m[K,
                 from [01m[Kmain.cc:1[m[K:
/usr/include/c++/8/ext/new_allocator.h: In instantiation of ‘[01m[Kvoid __gnu_cxx::new_allocator<_Tp>::construct(_Up*, _Args&& ...) [with _Up = AddExpr; _Args = {std::shared_ptr<Expr>&, std::shared_ptr<Expr>&, AddExpr::Private}; _Tp = AddExpr][m[K’:
[01m[K/usr/include/c++/8/bits/alloc_traits.h:475:4:[m[K   required from ‘[01m[Kstatic void std::allocator_traits<std::allocator<_CharT> >::construct(std::allocator_traits<std::allocator<_CharT> >::allocator_type&, _Up*, _Args&& ...) [with _Up = AddExpr; _Args = {std::shared_ptr<Expr>&, std::shared_ptr<Expr>&, AddExpr::Private}; _Tp = AddExpr; std::allocator_traits<std::allocator<_CharT> >::allocator_type = std::allocator<AddExpr>][m[K’
[01m[K/usr/include/c++/8/bits/shared_ptr_base.h:545:39:[m[K   required from ‘[01m[Kstd::_Sp_counted_ptr_inplace<_Tp, _Alloc, _Lp>::_Sp_counted_ptr_inplace(_Alloc, _Args&& ...) [with _Args = {std::shared_ptr<Expr>&, std::shared_ptr<Expr>&, AddExpr::Private}; _Tp = AddExpr; _Alloc = std::allocator<AddExpr>; __gnu_cxx::_Lock_policy _Lp = (__gnu_cxx::_Lock_policy)2][m[K’
[01m[K/usr/include/c++/8/bits/shared_ptr_base.h:677:16:[m[K   required from ‘[01m[Kstd::__shared_count<_Lp>::__shared_count(_Tp*&, std::_Sp_alloc_shared_tag<_Alloc>, _Args&& ...) [with _Tp = AddExpr; _Alloc = std::allocator<AddExpr>; _Args = {std::shared_ptr<Expr>&, std::shared_ptr<Expr>&, AddExpr::Private}; __gnu_cxx::_Lock_policy _Lp = (__gnu_cxx::_Lock_policy)2][m[K’
[01m[K/usr/include/c++/8/bits/shared_ptr_base.h:1342:71:[m[K   required from ‘[01m[Kstd::__shared_ptr<_Tp, _Lp>::__shared_ptr(std::_Sp_alloc_shared_tag<_Tp>, _Args&& ...) [with _Alloc = std::allocator<AddExpr>; _Args = {std::shared_ptr<Expr>&, std::shared_ptr<Expr>&, AddExpr::Private}; _Tp = AddExpr; __gnu_cxx::_Lock_policy _Lp = (__gnu_cxx::_Lock_policy)2][m[K’
[01m[K/usr/include/c++/8/bits/shared_ptr.h:359:59:[m[K   required from ‘[01m[Kstd::shared_ptr<_Tp>::shared_ptr(std::_Sp_alloc_shared_tag<_Tp>, _Args&& ...) [with _Alloc = std::allocator<AddExpr>; _Args = {std::shared_ptr<Expr>&, std::shared_ptr<Expr>&, AddExpr::Private}; _Tp = AddExpr][m[K’
[01m[K/usr/include/c++/8/bits/shared_ptr.h:705:14:[m[K   required from ‘[01m[Kstd::shared_ptr<_Tp> std::allocate_shared(const _Alloc&, _Args&& ...) [with _Tp = AddExpr; _Alloc = std::allocator<AddExpr>; _Args = {std::shared_ptr<Expr>&, std::shared_ptr<Expr>&, AddExpr::Private}][m[K’
[01m[K/usr/include/c++/8/bits/shared_ptr.h:721:39:[m[K   required from ‘[01m[Kstd::shared_ptr<_Tp> std::make_shared(_Args&& ...) [with _Tp = AddExpr; _Args = {std::shared_ptr<Expr>&, std::shared_ptr<Expr>&, AddExpr::Private}][m[K’
[01m[Kexpr.hh:55:63:[m[K   required from here
[01m[K/usr/include/c++/8/ext/new_allocator.h:136:4:[m[K [01;31m[Kerror: [m[Kno matching function for call to ‘[01m[KAddExpr::AddExpr(std::shared_ptr<Expr>&, std::shared_ptr<Expr>&, AddExpr::Private)[m[K’
  { [01;31m[K::new((void *)__p) _Up(std::forward<_Args>(__args)...)[m[K; }
    [01;31m[K^~~~~~~~~~~~~~~~~~~~~~~~~~~~~~~~~~~~~~~~~~~~~~~~~~~~~~[m[K
In file included from [01m[Kmain.cc:1[m[K:
[01m[Kexpr.hh:46:7:[m[K [01;36m[Knote: [m[Kcandidate: ‘[01m[Kconstexpr AddExpr::AddExpr()[m[K’
 class [01;36m[KAddExpr[m[K : public Expr {
       [01;36m[K^~~~~~~[m[K
[01m[Kexpr.hh:46:7:[m[K [01;36m[Knote: [m[K  candidate expects 0 arguments, 3 provided
[01m[Kexpr.hh:46:7:[m[K [01;36m[Knote: [m[Kcandidate: ‘[01m[KAddExpr::AddExpr(const AddExpr&)[m[K’
[01m[Kexpr.hh:46:7:[m[K [01;36m[Knote: [m[K  candidate expects 1 argument, 3 provided
[01m[Kexpr.hh:46:7:[m[K [01;36m[Knote: [m[Kcandidate: ‘[01m[KAddExpr::AddExpr(AddExpr&&)[m[K’
[01m[Kexpr.hh:46:7:[m[K [01;36m[Knote: [m[K  candidate expects 1 argument, 3 provided
make: *** [../Makefile:48: main.o] Error 1
aceylan1@g7-22:~/i240a/submit/lab4/3-expr$ make -f ../Makefile[6Pgedit expr.hhparse.cc[1Pexpr.ccparse.cc[1Pexpr.hhmake -f ../Makefile[Kmake -f ../Makefile[6Pgedit expr.hhparse.cc[1Pexpr.ccls[Kmake -f ../Makefile[6Pgedit main.cctoString.cc[3Pparse.cctoString.cc[4Pmain.ccmake -f ../Makefile[6Pgedit main.ccmake -f ../Makefile[6Pgedit main.cctoString.cc[3Pparse.ccls[Kgedit expr.hh

(gedit:116013): Gtk-[1;33mWARNING[0m **: [34m18:47:24.112[0m: Calling org.xfce.Session.Manager.Inhibit failed: GDBus.Error:org.freedesktop.DBus.Error.UnknownMethod: Method "Inhibit" with signature "susu" on interface "org.xfce.Session.Manager" doesn't exist

aceylan1@g7-22:~/i240a/submit/lab4/3-expr$ gedit expr.hhmake -f ../Makefile
g++ -MT main.o -MMD -MP -MF .deps/main.d -g -Wall -std=c++17 -c main.cc
In file included from [01m[Kmain.cc:1[m[K:
[01m[Kexpr.hh:60:11:[m[K [01;31m[Kerror: [m[Kexpected unqualified-id before ‘[01m[Kint[m[K’
   IntExpr([01;31m[Kint[m[K val, Private x) : value(val){}
           [01;31m[K^~~[m[K
[01m[Kexpr.hh:60:11:[m[K [01;31m[Kerror: [m[Kexpected ‘[01m[K)[m[K’ before ‘[01m[Kint[m[K’
   IntExpr[34m[K([m[K[01;31m[Ki[m[K[32m[Knt[m[K val, Private x) : value(val){}
          [34m[K~[m[K[01;31m[K^[m[K[32m[K~~[m[K
           [32m[K)[m[K
[01m[Kexpr.hh:64:42:[m[K [01;31m[Kerror: [m[K‘[01m[KPrivate[m[K’ has not been declared
   AddExpr(ExprPtr& left, ExprPtr& right, [01;31m[KPrivate[m[K x) :
                                          [01;31m[K^~~~~~~[m[K
[01m[Kexpr.hh:64:51:[m[K [01;31m[Kerror: [m[KISO C++ forbids declaration of ‘[01m[KAddExpr[m[K’ with no type [[01;31m[K-fpermissive[m[K]
   AddExpr(ExprPtr& left, ExprPtr& right, Private x[01;31m[K)[m[K :
                                                   [01;31m[K^[m[K
[01m[Kexpr.hh:[m[K In function ‘[01m[Kint AddExpr(ExprPtr&, ExprPtr&, int)[m[K’:
[01m[Kexpr.hh:65:5:[m[K [01;31m[Kerror: [m[Konly constructors take member initializers
     [01;31m[Kleft[m[K(left), right(right) {
     [01;31m[K^~~~[m[K
[01m[Kexpr.hh:66:3:[m[K [01;35m[Kwarning: [m[Kno return statement in function returning non-void [[01;35m[K-Wreturn-type[m[K]
   [01;35m[K}[m[K
   [01;35m[K^[m[K
[01m[Kexpr.hh:[m[K At global scope:
[01m[Kexpr.hh:67:1:[m[K [01;31m[Kerror: [m[Kexpected declaration before ‘[01m[K}[m[K’ token
 [01;31m[K}[m[K; //AddExpr
 [01;31m[K^[m[K
In file included from [01m[K/usr/include/x86_64-linux-gnu/c++/8/bits/c++allocator.h:33[m[K,
                 from [01m[K/usr/include/c++/8/bits/allocator.h:46[m[K,
                 from [01m[K/usr/include/c++/8/string:41[m[K,
                 from [01m[K/usr/include/c++/8/bits/locale_classes.h:40[m[K,
                 from [01m[K/usr/include/c++/8/bits/ios_base.h:41[m[K,
                 from [01m[K/usr/include/c++/8/ios:42[m[K,
                 from [01m[K/usr/include/c++/8/ostream:38[m[K,
                 from [01m[K/usr/include/c++/8/iostream:39[m[K,
                 from [01m[Ktostring.hh:4[m[K,
                 from [01m[Kexpr.hh:4[m[K,
                 from [01m[Kmain.cc:1[m[K:
/usr/include/c++/8/ext/new_allocator.h: In instantiation of ‘[01m[Kvoid __gnu_cxx::new_allocator<_Tp>::construct(_Up*, _Args&& ...) [with _Up = AddExpr; _Args = {std::shared_ptr<Expr>&, std::shared_ptr<Expr>&, AddExpr::Private}; _Tp = AddExpr][m[K’:
[01m[K/usr/include/c++/8/bits/alloc_traits.h:475:4:[m[K   required from ‘[01m[Kstatic void std::allocator_traits<std::allocator<_CharT> >::construct(std::allocator_traits<std::allocator<_CharT> >::allocator_type&, _Up*, _Args&& ...) [with _Up = AddExpr; _Args = {std::shared_ptr<Expr>&, std::shared_ptr<Expr>&, AddExpr::Private}; _Tp = AddExpr; std::allocator_traits<std::allocator<_CharT> >::allocator_type = std::allocator<AddExpr>][m[K’
[01m[K/usr/include/c++/8/bits/shared_ptr_base.h:545:39:[m[K   required from ‘[01m[Kstd::_Sp_counted_ptr_inplace<_Tp, _Alloc, _Lp>::_Sp_counted_ptr_inplace(_Alloc, _Args&& ...) [with _Args = {std::shared_ptr<Expr>&, std::shared_ptr<Expr>&, AddExpr::Private}; _Tp = AddExpr; _Alloc = std::allocator<AddExpr>; __gnu_cxx::_Lock_policy _Lp = (__gnu_cxx::_Lock_policy)2][m[K’
[01m[K/usr/include/c++/8/bits/shared_ptr_base.h:677:16:[m[K   required from ‘[01m[Kstd::__shared_count<_Lp>::__shared_count(_Tp*&, std::_Sp_alloc_shared_tag<_Alloc>, _Args&& ...) [with _Tp = AddExpr; _Alloc = std::allocator<AddExpr>; _Args = {std::shared_ptr<Expr>&, std::shared_ptr<Expr>&, AddExpr::Private}; __gnu_cxx::_Lock_policy _Lp = (__gnu_cxx::_Lock_policy)2][m[K’
[01m[K/usr/include/c++/8/bits/shared_ptr_base.h:1342:71:[m[K   required from ‘[01m[Kstd::__shared_ptr<_Tp, _Lp>::__shared_ptr(std::_Sp_alloc_shared_tag<_Tp>, _Args&& ...) [with _Alloc = std::allocator<AddExpr>; _Args = {std::shared_ptr<Expr>&, std::shared_ptr<Expr>&, AddExpr::Private}; _Tp = AddExpr; __gnu_cxx::_Lock_policy _Lp = (__gnu_cxx::_Lock_policy)2][m[K’
[01m[K/usr/include/c++/8/bits/shared_ptr.h:359:59:[m[K   required from ‘[01m[Kstd::shared_ptr<_Tp>::shared_ptr(std::_Sp_alloc_shared_tag<_Tp>, _Args&& ...) [with _Alloc = std::allocator<AddExpr>; _Args = {std::shared_ptr<Expr>&, std::shared_ptr<Expr>&, AddExpr::Private}; _Tp = AddExpr][m[K’
[01m[K/usr/include/c++/8/bits/shared_ptr.h:705:14:[m[K   required from ‘[01m[Kstd::shared_ptr<_Tp> std::allocate_shared(const _Alloc&, _Args&& ...) [with _Tp = AddExpr; _Alloc = std::allocator<AddExpr>; _Args = {std::shared_ptr<Expr>&, std::shared_ptr<Expr>&, AddExpr::Private}][m[K’
[01m[K/usr/include/c++/8/bits/shared_ptr.h:721:39:[m[K   required from ‘[01m[Kstd::shared_ptr<_Tp> std::make_shared(_Args&& ...) [with _Tp = AddExpr; _Args = {std::shared_ptr<Expr>&, std::shared_ptr<Expr>&, AddExpr::Private}][m[K’
[01m[Kexpr.hh:53:63:[m[K   required from here
[01m[K/usr/include/c++/8/ext/new_allocator.h:136:4:[m[K [01;31m[Kerror: [m[Kno matching function for call to ‘[01m[KAddExpr::AddExpr(std::shared_ptr<Expr>&, std::shared_ptr<Expr>&, AddExpr::Private)[m[K’
  { [01;31m[K::new((void *)__p) _Up(std::forward<_Args>(__args)...)[m[K; }
    [01;31m[K^~~~~~~~~~~~~~~~~~~~~~~~~~~~~~~~~~~~~~~~~~~~~~~~~~~~~~[m[K
In file included from [01m[Kmain.cc:1[m[K:
[01m[Kexpr.hh:44:7:[m[K [01;36m[Knote: [m[Kcandidate: ‘[01m[Kconstexpr AddExpr::AddExpr()[m[K’
 class [01;36m[KAddExpr[m[K : public Expr {
       [01;36m[K^~~~~~~[m[K
[01m[Kexpr.hh:44:7:[m[K [01;36m[Knote: [m[K  candidate expects 0 arguments, 3 provided
[01m[Kexpr.hh:44:7:[m[K [01;36m[Knote: [m[Kcandidate: ‘[01m[KAddExpr::AddExpr(const AddExpr&)[m[K’
[01m[Kexpr.hh:44:7:[m[K [01;36m[Knote: [m[K  candidate expects 1 argument, 3 provided
[01m[Kexpr.hh:44:7:[m[K [01;36m[Knote: [m[Kcandidate: ‘[01m[KAddExpr::AddExpr(AddExpr&&)[m[K’
[01m[Kexpr.hh:44:7:[m[K [01;36m[Knote: [m[K  candidate expects 1 argument, 3 provided
make: *** [../Makefile:48: main.o] Error 1
aceylan1@g7-22:~/i240a/submit/lab4/3-expr$ [Kaceylan1@g7-22:~/i240a/submit/lab4/3-expr$ [Kaceylan1@g7-22:~/i240a/submit/lab4/3-expr$ make -f ../Makefile[6Pgedit expr.hhmake -f ../Makefile[6Pgedit expr.hhparse.cc[1Pexpr.ccls[Kmake -f ../Makefile[6Pgedit main.cc

(gedit:116033): Gtk-[1;33mWARNING[0m **: [34m18:51:07.972[0m: Calling org.xfce.Session.Manager.Inhibit failed: GDBus.Error:org.freedesktop.DBus.Error.UnknownMethod: Method "Inhibit" with signature "susu" on interface "org.xfce.Session.Manager" doesn't exist

aceylan1@g7-22:~/i240a/submit/lab4/3-expr$ gedit main.ccmake -f ../Makefile
\g++ -MT main.o -MMD -MP -MF .deps/main.d -g -Wall -std=c++17 -c main.cc
In file included from [01m[Kmain.cc:1[m[K:
[01m[Kexpr.hh:60:11:[m[K [01;31m[Kerror: [m[Kexpected unqualified-id before ‘[01m[Kint[m[K’
   IntExpr([01;31m[Kint[m[K val, Private x) : value(val){}
           [01;31m[K^~~[m[K
[01m[Kexpr.hh:60:11:[m[K [01;31m[Kerror: [m[Kexpected ‘[01m[K)[m[K’ before ‘[01m[Kint[m[K’
   IntExpr[34m[K([m[K[01;31m[Ki[m[K[32m[Knt[m[K val, Private x) : value(val){}
          [34m[K~[m[K[01;31m[K^[m[K[32m[K~~[m[K
           [32m[K)[m[K
[01m[Kexpr.hh:64:42:[m[K [01;31m[Kerror: [m[K‘[01m[KPrivate[m[K’ has not been declared
   AddExpr(ExprPtr& left, ExprPtr& right, [01;31m[KPrivate[m[K x) :
                                          [01;31m[K^~~~~~~[m[K
[01m[Kexpr.hh:64:51:[m[K [01;31m[Kerror: [m[KISO C++ forbids declaration of ‘[01m[KAddExpr[m[K’ with no type [[01;31m[K-fpermissive[m[K]
   AddExpr(ExprPtr& left, ExprPtr& right, Private x[01;31m[K)[m[K :
                                                   [01;31m[K^[m[K
[01m[Kexpr.hh:[m[K In function ‘[01m[Kint AddExpr(ExprPtr&, ExprPtr&, int)[m[K’:
[01m[Kexpr.hh:65:5:[m[K [01;31m[Kerror: [m[Konly constructors take member initializers
     [01;31m[Kleft[m[K(left), right(right) {
     [01;31m[K^~~~[m[K
[01m[Kexpr.hh:66:3:[m[K [01;35m[Kwarning: [m[Kno return statement in function returning non-void [[01;35m[K-Wreturn-type[m[K]
   [01;35m[K}[m[K
   [01;35m[K^[m[K
[01m[Kexpr.hh:[m[K At global scope:
[01m[Kexpr.hh:67:1:[m[K [01;31m[Kerror: [m[Kexpected declaration before ‘[01m[K}[m[K’ token
 [01;31m[K}[m[K; //AddExpr
 [01;31m[K^[m[K
In file included from [01m[K/usr/include/x86_64-linux-gnu/c++/8/bits/c++allocator.h:33[m[K,
                 from [01m[K/usr/include/c++/8/bits/allocator.h:46[m[K,
                 from [01m[K/usr/include/c++/8/string:41[m[K,
                 from [01m[K/usr/include/c++/8/bits/locale_classes.h:40[m[K,
                 from [01m[K/usr/include/c++/8/bits/ios_base.h:41[m[K,
                 from [01m[K/usr/include/c++/8/ios:42[m[K,
                 from [01m[K/usr/include/c++/8/ostream:38[m[K,
                 from [01m[K/usr/include/c++/8/iostream:39[m[K,
                 from [01m[Ktostring.hh:4[m[K,
                 from [01m[Kexpr.hh:4[m[K,
                 from [01m[Kmain.cc:1[m[K:
/usr/include/c++/8/ext/new_allocator.h: In instantiation of ‘[01m[Kvoid __gnu_cxx::new_allocator<_Tp>::construct(_Up*, _Args&& ...) [with _Up = AddExpr; _Args = {std::shared_ptr<Expr>&, std::shared_ptr<Expr>&, AddExpr::Private}; _Tp = AddExpr][m[K’:
[01m[K/usr/include/c++/8/bits/alloc_traits.h:475:4:[m[K   required from ‘[01m[Kstatic void std::allocator_traits<std::allocator<_CharT> >::construct(std::allocator_traits<std::allocator<_CharT> >::allocator_type&, _Up*, _Args&& ...) [with _Up = AddExpr; _Args = {std::shared_ptr<Expr>&, std::shared_ptr<Expr>&, AddExpr::Private}; _Tp = AddExpr; std::allocator_traits<std::allocator<_CharT> >::allocator_type = std::allocator<AddExpr>][m[K’
[01m[K/usr/include/c++/8/bits/shared_ptr_base.h:545:39:[m[K   required from ‘[01m[Kstd::_Sp_counted_ptr_inplace<_Tp, _Alloc, _Lp>::_Sp_counted_ptr_inplace(_Alloc, _Args&& ...) [with _Args = {std::shared_ptr<Expr>&, std::shared_ptr<Expr>&, AddExpr::Private}; _Tp = AddExpr; _Alloc = std::allocator<AddExpr>; __gnu_cxx::_Lock_policy _Lp = (__gnu_cxx::_Lock_policy)2][m[K’
[01m[K/usr/include/c++/8/bits/shared_ptr_base.h:677:16:[m[K   required from ‘[01m[Kstd::__shared_count<_Lp>::__shared_count(_Tp*&, std::_Sp_alloc_shared_tag<_Alloc>, _Args&& ...) [with _Tp = AddExpr; _Alloc = std::allocator<AddExpr>; _Args = {std::shared_ptr<Expr>&, std::shared_ptr<Expr>&, AddExpr::Private}; __gnu_cxx::_Lock_policy _Lp = (__gnu_cxx::_Lock_policy)2][m[K’
[01m[K/usr/include/c++/8/bits/shared_ptr_base.h:1342:71:[m[K   required from ‘[01m[Kstd::__shared_ptr<_Tp, _Lp>::__shared_ptr(std::_Sp_alloc_shared_tag<_Tp>, _Args&& ...) [with _Alloc = std::allocator<AddExpr>; _Args = {std::shared_ptr<Expr>&, std::shared_ptr<Expr>&, AddExpr::Private}; _Tp = AddExpr; __gnu_cxx::_Lock_policy _Lp = (__gnu_cxx::_Lock_policy)2][m[K’
[01m[K/usr/include/c++/8/bits/shared_ptr.h:359:59:[m[K   required from ‘[01m[Kstd::shared_ptr<_Tp>::shared_ptr(std::_Sp_alloc_shared_tag<_Tp>, _Args&& ...) [with _Alloc = std::allocator<AddExpr>; _Args = {std::shared_ptr<Expr>&, std::shared_ptr<Expr>&, AddExpr::Private}; _Tp = AddExpr][m[K’
[01m[K/usr/include/c++/8/bits/shared_ptr.h:705:14:[m[K   required from ‘[01m[Kstd::shared_ptr<_Tp> std::allocate_shared(const _Alloc&, _Args&& ...) [with _Tp = AddExpr; _Alloc = std::allocator<AddExpr>; _Args = {std::shared_ptr<Expr>&, std::shared_ptr<Expr>&, AddExpr::Private}][m[K’
[01m[K/usr/include/c++/8/bits/shared_ptr.h:721:39:[m[K   required from ‘[01m[Kstd::shared_ptr<_Tp> std::make_shared(_Args&& ...) [with _Tp = AddExpr; _Args = {std::shared_ptr<Expr>&, std::shared_ptr<Expr>&, AddExpr::Private}][m[K’
[01m[Kexpr.hh:53:63:[m[K   required from here
[01m[K/usr/include/c++/8/ext/new_allocator.h:136:4:[m[K [01;31m[Kerror: [m[Kno matching function for call to ‘[01m[KAddExpr::AddExpr(std::shared_ptr<Expr>&, std::shared_ptr<Expr>&, AddExpr::Private)[m[K’
  { [01;31m[K::new((void *)__p) _Up(std::forward<_Args>(__args)...)[m[K; }
    [01;31m[K^~~~~~~~~~~~~~~~~~~~~~~~~~~~~~~~~~~~~~~~~~~~~~~~~~~~~~[m[K
In file included from [01m[Kmain.cc:1[m[K:
[01m[Kexpr.hh:44:7:[m[K [01;36m[Knote: [m[Kcandidate: ‘[01m[Kconstexpr AddExpr::AddExpr()[m[K’
 class [01;36m[KAddExpr[m[K : public Expr {
       [01;36m[K^~~~~~~[m[K
[01m[Kexpr.hh:44:7:[m[K [01;36m[Knote: [m[K  candidate expects 0 arguments, 3 provided
[01m[Kexpr.hh:44:7:[m[K [01;36m[Knote: [m[Kcandidate: ‘[01m[KAddExpr::AddExpr(const AddExpr&)[m[K’
[01m[Kexpr.hh:44:7:[m[K [01;36m[Knote: [m[K  candidate expects 1 argument, 3 provided
[01m[Kexpr.hh:44:7:[m[K [01;36m[Knote: [m[Kcandidate: ‘[01m[KAddExpr::AddExpr(AddExpr&&)[m[K’
[01m[Kexpr.hh:44:7:[m[K [01;36m[Knote: [m[K  candidate expects 1 argument, 3 provided
make: *** [../Makefile:48: main.o] Error 1
aceylan1@g7-22:~/i240a/submit/lab4/3-expr$ \[Kmake -f ../Makefile[6Pgedit main.cc

(gedit:116044): Gtk-[1;33mWARNING[0m **: [34m18:51:41.284[0m: Calling org.xfce.Session.Manager.Inhibit failed: GDBus.Error:org.freedesktop.DBus.Error.UnknownMethod: Method "Inhibit" with signature "susu" on interface "org.xfce.Session.Manager" doesn't exist

aceylan1@g7-22:~/i240a/submit/lab4/3-expr$ gedit main.ccmake -f ../Makefile
g++ -MT main.o -MMD -MP -MF .deps/main.d -g -Wall -std=c++17 -c main.cc
In file included from [01m[Kmain.cc:1[m[K:
[01m[Kexpr.hh:60:11:[m[K [01;31m[Kerror: [m[Kexpected unqualified-id before ‘[01m[Kint[m[K’
   IntExpr([01;31m[Kint[m[K val, Private x) : value(val){}
           [01;31m[K^~~[m[K
[01m[Kexpr.hh:60:11:[m[K [01;31m[Kerror: [m[Kexpected ‘[01m[K)[m[K’ before ‘[01m[Kint[m[K’
   IntExpr[34m[K([m[K[01;31m[Ki[m[K[32m[Knt[m[K val, Private x) : value(val){}
          [34m[K~[m[K[01;31m[K^[m[K[32m[K~~[m[K
           [32m[K)[m[K
[01m[Kexpr.hh:64:42:[m[K [01;31m[Kerror: [m[K‘[01m[KPrivate[m[K’ has not been declared
   AddExpr(ExprPtr& left, ExprPtr& right, [01;31m[KPrivate[m[K x) :
                                          [01;31m[K^~~~~~~[m[K
[01m[Kexpr.hh:64:51:[m[K [01;31m[Kerror: [m[KISO C++ forbids declaration of ‘[01m[KAddExpr[m[K’ with no type [[01;31m[K-fpermissive[m[K]
   AddExpr(ExprPtr& left, ExprPtr& right, Private x[01;31m[K)[m[K :
                                                   [01;31m[K^[m[K
[01m[Kexpr.hh:[m[K In function ‘[01m[Kint AddExpr(ExprPtr&, ExprPtr&, int)[m[K’:
[01m[Kexpr.hh:65:5:[m[K [01;31m[Kerror: [m[Konly constructors take member initializers
     [01;31m[Kleft[m[K(left), right(right) {
     [01;31m[K^~~~[m[K
[01m[Kexpr.hh:66:3:[m[K [01;35m[Kwarning: [m[Kno return statement in function returning non-void [[01;35m[K-Wreturn-type[m[K]
   [01;35m[K}[m[K
   [01;35m[K^[m[K
[01m[Kexpr.hh:[m[K At global scope:
[01m[Kexpr.hh:67:1:[m[K [01;31m[Kerror: [m[Kexpected declaration before ‘[01m[K}[m[K’ token
 [01;31m[K}[m[K; //AddExpr
 [01;31m[K^[m[K
In file included from [01m[K/usr/include/x86_64-linux-gnu/c++/8/bits/c++allocator.h:33[m[K,
                 from [01m[K/usr/include/c++/8/bits/allocator.h:46[m[K,
                 from [01m[K/usr/include/c++/8/string:41[m[K,
                 from [01m[K/usr/include/c++/8/bits/locale_classes.h:40[m[K,
                 from [01m[K/usr/include/c++/8/bits/ios_base.h:41[m[K,
                 from [01m[K/usr/include/c++/8/ios:42[m[K,
                 from [01m[K/usr/include/c++/8/ostream:38[m[K,
                 from [01m[K/usr/include/c++/8/iostream:39[m[K,
                 from [01m[Ktostring.hh:4[m[K,
                 from [01m[Kexpr.hh:4[m[K,
                 from [01m[Kmain.cc:1[m[K:
/usr/include/c++/8/ext/new_allocator.h: In instantiation of ‘[01m[Kvoid __gnu_cxx::new_allocator<_Tp>::construct(_Up*, _Args&& ...) [with _Up = AddExpr; _Args = {std::shared_ptr<Expr>&, std::shared_ptr<Expr>&, AddExpr::Private}; _Tp = AddExpr][m[K’:
[01m[K/usr/include/c++/8/bits/alloc_traits.h:475:4:[m[K   required from ‘[01m[Kstatic void std::allocator_traits<std::allocator<_CharT> >::construct(std::allocator_traits<std::allocator<_CharT> >::allocator_type&, _Up*, _Args&& ...) [with _Up = AddExpr; _Args = {std::shared_ptr<Expr>&, std::shared_ptr<Expr>&, AddExpr::Private}; _Tp = AddExpr; std::allocator_traits<std::allocator<_CharT> >::allocator_type = std::allocator<AddExpr>][m[K’
[01m[K/usr/include/c++/8/bits/shared_ptr_base.h:545:39:[m[K   required from ‘[01m[Kstd::_Sp_counted_ptr_inplace<_Tp, _Alloc, _Lp>::_Sp_counted_ptr_inplace(_Alloc, _Args&& ...) [with _Args = {std::shared_ptr<Expr>&, std::shared_ptr<Expr>&, AddExpr::Private}; _Tp = AddExpr; _Alloc = std::allocator<AddExpr>; __gnu_cxx::_Lock_policy _Lp = (__gnu_cxx::_Lock_policy)2][m[K’
[01m[K/usr/include/c++/8/bits/shared_ptr_base.h:677:16:[m[K   required from ‘[01m[Kstd::__shared_count<_Lp>::__shared_count(_Tp*&, std::_Sp_alloc_shared_tag<_Alloc>, _Args&& ...) [with _Tp = AddExpr; _Alloc = std::allocator<AddExpr>; _Args = {std::shared_ptr<Expr>&, std::shared_ptr<Expr>&, AddExpr::Private}; __gnu_cxx::_Lock_policy _Lp = (__gnu_cxx::_Lock_policy)2][m[K’
[01m[K/usr/include/c++/8/bits/shared_ptr_base.h:1342:71:[m[K   required from ‘[01m[Kstd::__shared_ptr<_Tp, _Lp>::__shared_ptr(std::_Sp_alloc_shared_tag<_Tp>, _Args&& ...) [with _Alloc = std::allocator<AddExpr>; _Args = {std::shared_ptr<Expr>&, std::shared_ptr<Expr>&, AddExpr::Private}; _Tp = AddExpr; __gnu_cxx::_Lock_policy _Lp = (__gnu_cxx::_Lock_policy)2][m[K’
[01m[K/usr/include/c++/8/bits/shared_ptr.h:359:59:[m[K   required from ‘[01m[Kstd::shared_ptr<_Tp>::shared_ptr(std::_Sp_alloc_shared_tag<_Tp>, _Args&& ...) [with _Alloc = std::allocator<AddExpr>; _Args = {std::shared_ptr<Expr>&, std::shared_ptr<Expr>&, AddExpr::Private}; _Tp = AddExpr][m[K’
[01m[K/usr/include/c++/8/bits/shared_ptr.h:705:14:[m[K   required from ‘[01m[Kstd::shared_ptr<_Tp> std::allocate_shared(const _Alloc&, _Args&& ...) [with _Tp = AddExpr; _Alloc = std::allocator<AddExpr>; _Args = {std::shared_ptr<Expr>&, std::shared_ptr<Expr>&, AddExpr::Private}][m[K’
[01m[K/usr/include/c++/8/bits/shared_ptr.h:721:39:[m[K   required from ‘[01m[Kstd::shared_ptr<_Tp> std::make_shared(_Args&& ...) [with _Tp = AddExpr; _Args = {std::shared_ptr<Expr>&, std::shared_ptr<Expr>&, AddExpr::Private}][m[K’
[01m[Kexpr.hh:53:63:[m[K   required from here
[01m[K/usr/include/c++/8/ext/new_allocator.h:136:4:[m[K [01;31m[Kerror: [m[Kno matching function for call to ‘[01m[KAddExpr::AddExpr(std::shared_ptr<Expr>&, std::shared_ptr<Expr>&, AddExpr::Private)[m[K’
  { [01;31m[K::new((void *)__p) _Up(std::forward<_Args>(__args)...)[m[K; }
    [01;31m[K^~~~~~~~~~~~~~~~~~~~~~~~~~~~~~~~~~~~~~~~~~~~~~~~~~~~~~[m[K
In file included from [01m[Kmain.cc:1[m[K:
[01m[Kexpr.hh:44:7:[m[K [01;36m[Knote: [m[Kcandidate: ‘[01m[Kconstexpr AddExpr::AddExpr()[m[K’
 class [01;36m[KAddExpr[m[K : public Expr {
       [01;36m[K^~~~~~~[m[K
[01m[Kexpr.hh:44:7:[m[K [01;36m[Knote: [m[K  candidate expects 0 arguments, 3 provided
[01m[Kexpr.hh:44:7:[m[K [01;36m[Knote: [m[Kcandidate: ‘[01m[KAddExpr::AddExpr(const AddExpr&)[m[K’
[01m[Kexpr.hh:44:7:[m[K [01;36m[Knote: [m[K  candidate expects 1 argument, 3 provided
[01m[Kexpr.hh:44:7:[m[K [01;36m[Knote: [m[Kcandidate: ‘[01m[KAddExpr::AddExpr(AddExpr&&)[m[K’
[01m[Kexpr.hh:44:7:[m[K [01;36m[Knote: [m[K  candidate expects 1 argument, 3 provided
make: *** [../Makefile:48: main.o] Error 1
aceylan1@g7-22:~/i240a/submit/lab4/3-expr$ make -f ../Makefile[6Pgedit main.ccmake -f ../Makefile[6Pgedit main.ccmake -f ../Makefile[6Pgedit expr.hh

(gedit:116057): Gtk-[1;33mWARNING[0m **: [34m18:53:10.595[0m: Calling org.xfce.Session.Manager.Inhibit failed: GDBus.Error:org.freedesktop.DBus.Error.UnknownMethod: Method "Inhibit" with signature "susu" on interface "org.xfce.Session.Manager" doesn't exist

aceylan1@g7-22:~/i240a/submit/lab4/3-expr$ gedit expr.hhmake -f ../Makefile[6Pgedit expr.hhmake -f ../Makefile
g++ -MT main.o -MMD -MP -MF .deps/main.d -g -Wall -std=c++17 -c main.cc
In file included from [01m[Kmain.cc:1[m[K:
[01m[Kexpr.hh:36:48:[m[K [01;31m[Kerror: [m[K‘[01m[Kasdasdasd[m[K’ does not name a type
   IntExpr(int val, Private x) : value(val) { } [01;31m[Kasdasdasd[m[K
                                                [01;31m[K^~~~~~~~~[m[K
[01m[Kexpr.hh:60:11:[m[K [01;31m[Kerror: [m[Kexpected unqualified-id before ‘[01m[Kint[m[K’
   IntExpr([01;31m[Kint[m[K val, Private x) : value(val){}
           [01;31m[K^~~[m[K
[01m[Kexpr.hh:60:11:[m[K [01;31m[Kerror: [m[Kexpected ‘[01m[K)[m[K’ before ‘[01m[Kint[m[K’
   IntExpr[34m[K([m[K[01;31m[Ki[m[K[32m[Knt[m[K val, Private x) : value(val){}
          [34m[K~[m[K[01;31m[K^[m[K[32m[K~~[m[K
           [32m[K)[m[K
[01m[Kexpr.hh:64:42:[m[K [01;31m[Kerror: [m[K‘[01m[KPrivate[m[K’ has not been declared
   AddExpr(ExprPtr& left, ExprPtr& right, [01;31m[KPrivate[m[K x) :
                                          [01;31m[K^~~~~~~[m[K
[01m[Kexpr.hh:64:51:[m[K [01;31m[Kerror: [m[KISO C++ forbids declaration of ‘[01m[KAddExpr[m[K’ with no type [[01;31m[K-fpermissive[m[K]
   AddExpr(ExprPtr& left, ExprPtr& right, Private x[01;31m[K)[m[K :
                                                   [01;31m[K^[m[K
[01m[Kexpr.hh:[m[K In function ‘[01m[Kint AddExpr(ExprPtr&, ExprPtr&, int)[m[K’:
[01m[Kexpr.hh:65:5:[m[K [01;31m[Kerror: [m[Konly constructors take member initializers
     [01;31m[Kleft[m[K(left), right(right) {
     [01;31m[K^~~~[m[K
[01m[Kexpr.hh:66:3:[m[K [01;35m[Kwarning: [m[Kno return statement in function returning non-void [[01;35m[K-Wreturn-type[m[K]
   [01;35m[K}[m[K
   [01;35m[K^[m[K
[01m[Kexpr.hh:[m[K At global scope:
[01m[Kexpr.hh:67:1:[m[K [01;31m[Kerror: [m[Kexpected declaration before ‘[01m[K}[m[K’ token
 [01;31m[K}[m[K; //AddExpr
 [01;31m[K^[m[K
In file included from [01m[K/usr/include/x86_64-linux-gnu/c++/8/bits/c++allocator.h:33[m[K,
                 from [01m[K/usr/include/c++/8/bits/allocator.h:46[m[K,
                 from [01m[K/usr/include/c++/8/string:41[m[K,
                 from [01m[K/usr/include/c++/8/bits/locale_classes.h:40[m[K,
                 from [01m[K/usr/include/c++/8/bits/ios_base.h:41[m[K,
                 from [01m[K/usr/include/c++/8/ios:42[m[K,
                 from [01m[K/usr/include/c++/8/ostream:38[m[K,
                 from [01m[K/usr/include/c++/8/iostream:39[m[K,
                 from [01m[Ktostring.hh:4[m[K,
                 from [01m[Kexpr.hh:4[m[K,
                 from [01m[Kmain.cc:1[m[K:
/usr/include/c++/8/ext/new_allocator.h: In instantiation of ‘[01m[Kvoid __gnu_cxx::new_allocator<_Tp>::construct(_Up*, _Args&& ...) [with _Up = AddExpr; _Args = {std::shared_ptr<Expr>&, std::shared_ptr<Expr>&, AddExpr::Private}; _Tp = AddExpr][m[K’:
[01m[K/usr/include/c++/8/bits/alloc_traits.h:475:4:[m[K   required from ‘[01m[Kstatic void std::allocator_traits<std::allocator<_CharT> >::construct(std::allocator_traits<std::allocator<_CharT> >::allocator_type&, _Up*, _Args&& ...) [with _Up = AddExpr; _Args = {std::shared_ptr<Expr>&, std::shared_ptr<Expr>&, AddExpr::Private}; _Tp = AddExpr; std::allocator_traits<std::allocator<_CharT> >::allocator_type = std::allocator<AddExpr>][m[K’
[01m[K/usr/include/c++/8/bits/shared_ptr_base.h:545:39:[m[K   required from ‘[01m[Kstd::_Sp_counted_ptr_inplace<_Tp, _Alloc, _Lp>::_Sp_counted_ptr_inplace(_Alloc, _Args&& ...) [with _Args = {std::shared_ptr<Expr>&, std::shared_ptr<Expr>&, AddExpr::Private}; _Tp = AddExpr; _Alloc = std::allocator<AddExpr>; __gnu_cxx::_Lock_policy _Lp = (__gnu_cxx::_Lock_policy)2][m[K’
[01m[K/usr/include/c++/8/bits/shared_ptr_base.h:677:16:[m[K   required from ‘[01m[Kstd::__shared_count<_Lp>::__shared_count(_Tp*&, std::_Sp_alloc_shared_tag<_Alloc>, _Args&& ...) [with _Tp = AddExpr; _Alloc = std::allocator<AddExpr>; _Args = {std::shared_ptr<Expr>&, std::shared_ptr<Expr>&, AddExpr::Private}; __gnu_cxx::_Lock_policy _Lp = (__gnu_cxx::_Lock_policy)2][m[K’
[01m[K/usr/include/c++/8/bits/shared_ptr_base.h:1342:71:[m[K   required from ‘[01m[Kstd::__shared_ptr<_Tp, _Lp>::__shared_ptr(std::_Sp_alloc_shared_tag<_Tp>, _Args&& ...) [with _Alloc = std::allocator<AddExpr>; _Args = {std::shared_ptr<Expr>&, std::shared_ptr<Expr>&, AddExpr::Private}; _Tp = AddExpr; __gnu_cxx::_Lock_policy _Lp = (__gnu_cxx::_Lock_policy)2][m[K’
[01m[K/usr/include/c++/8/bits/shared_ptr.h:359:59:[m[K   required from ‘[01m[Kstd::shared_ptr<_Tp>::shared_ptr(std::_Sp_alloc_shared_tag<_Tp>, _Args&& ...) [with _Alloc = std::allocator<AddExpr>; _Args = {std::shared_ptr<Expr>&, std::shared_ptr<Expr>&, AddExpr::Private}; _Tp = AddExpr][m[K’
[01m[K/usr/include/c++/8/bits/shared_ptr.h:705:14:[m[K   required from ‘[01m[Kstd::shared_ptr<_Tp> std::allocate_shared(const _Alloc&, _Args&& ...) [with _Tp = AddExpr; _Alloc = std::allocator<AddExpr>; _Args = {std::shared_ptr<Expr>&, std::shared_ptr<Expr>&, AddExpr::Private}][m[K’
[01m[K/usr/include/c++/8/bits/shared_ptr.h:721:39:[m[K   required from ‘[01m[Kstd::shared_ptr<_Tp> std::make_shared(_Args&& ...) [with _Tp = AddExpr; _Args = {std::shared_ptr<Expr>&, std::shared_ptr<Expr>&, AddExpr::Private}][m[K’
[01m[Kexpr.hh:53:63:[m[K   required from here
[01m[K/usr/include/c++/8/ext/new_allocator.h:136:4:[m[K [01;31m[Kerror: [m[Kno matching function for call to ‘[01m[KAddExpr::AddExpr(std::shared_ptr<Expr>&, std::shared_ptr<Expr>&, AddExpr::Private)[m[K’
  { [01;31m[K::new((void *)__p) _Up(std::forward<_Args>(__args)...)[m[K; }
    [01;31m[K^~~~~~~~~~~~~~~~~~~~~~~~~~~~~~~~~~~~~~~~~~~~~~~~~~~~~~[m[K
In file included from [01m[Kmain.cc:1[m[K:
[01m[Kexpr.hh:44:7:[m[K [01;36m[Knote: [m[Kcandidate: ‘[01m[Kconstexpr AddExpr::AddExpr()[m[K’
 class [01;36m[KAddExpr[m[K : public Expr {
       [01;36m[K^~~~~~~[m[K
[01m[Kexpr.hh:44:7:[m[K [01;36m[Knote: [m[K  candidate expects 0 arguments, 3 provided
[01m[Kexpr.hh:44:7:[m[K [01;36m[Knote: [m[Kcandidate: ‘[01m[KAddExpr::AddExpr(const AddExpr&)[m[K’
[01m[Kexpr.hh:44:7:[m[K [01;36m[Knote: [m[K  candidate expects 1 argument, 3 provided
[01m[Kexpr.hh:44:7:[m[K [01;36m[Knote: [m[Kcandidate: ‘[01m[KAddExpr::AddExpr(AddExpr&&)[m[K’
[01m[Kexpr.hh:44:7:[m[K [01;36m[Knote: [m[K  candidate expects 1 argument, 3 provided
make: *** [../Makefile:48: main.o] Error 1
aceylan1@g7-22:~/i240a/submit/lab4/3-expr$ make -f ../Makefile[6Pgedit expr.hh

(gedit:116070): Gtk-[1;33mWARNING[0m **: [34m18:54:21.576[0m: Calling org.xfce.Session.Manager.Inhibit failed: GDBus.Error:org.freedesktop.DBus.Error.UnknownMethod: Method "Inhibit" with signature "susu" on interface "org.xfce.Session.Manager" doesn't exist

aceylan1@g7-22:~/i240a/submit/lab4/3-expr$ gedit expr.hhmake -f ../Makefile
g++ -MT main.o -MMD -MP -MF .deps/main.d -g -Wall -std=c++17 -c main.cc
g++ -MT parse.o -MMD -MP -MF .deps/parse.d -g -Wall -std=c++17 -c parse.cc
g++ -MT expr.o -MMD -MP -MF .deps/expr.d -g -Wall -std=c++17 -c expr.cc
g++ tostring.o main.o parse.o expr.o -o main
cat </dev/null >.gitignore
echo .deps >.gitignore
for t in main tostring.o main.o parse.o expr.o; do echo $t >>.gitignore; done
aceylan1@g7-22:~/i240a/submit/lab4/3-expr$ make -f ../Makefile[6Pgedit expr.hh

(gedit:116100): Gtk-[1;33mWARNING[0m **: [34m18:57:03.178[0m: Calling org.xfce.Session.Manager.Inhibit failed: GDBus.Error:org.freedesktop.DBus.Error.UnknownMethod: Method "Inhibit" with signature "susu" on interface "org.xfce.Session.Manager" doesn't exist

aceylan1@g7-22:~/i240a/submit/lab4/3-expr$ gedit expr.hhmake -f ../Makefile
g++ -MT main.o -MMD -MP -MF .deps/main.d -g -Wall -std=c++17 -c main.cc
g++ -MT parse.o -MMD -MP -MF .deps/parse.d -g -Wall -std=c++17 -c parse.cc
g++ -MT expr.o -MMD -MP -MF .deps/expr.d -g -Wall -std=c++17 -c expr.cc
g++ tostring.o main.o parse.o expr.o -o main
aceylan1@g7-22:~/i240a/submit/lab4/3-expr$ ./main
usage: ./main PREFIX_EXPR...
aceylan1@g7-22:~/i240a/submit/lab4/3-expr$ cd
aceylan1@g7-22:~$ exit

Script done on 2020-02-20 18:59:41-05:00 [COMMAND_EXIT_CODE="0"]
